###################################
### RU lang for Tomato (Shibby) ###
###################################
0 to disable=0 для отключения
10 minute window, 2 second interval=график за 10 минут, интервал 2 секунды
2 minute interval=интервал 2 мин.
3G Modem=3G модем
3G Modem support=Поддержка 3G-модемов
3G only=Только 3G
4G/3G only=Только 4G/3G
4G/LTE Modem support=Поддержка 4G/LTE-модемов
4G only=Только 4G
6in4 Static Tunnel=Постоянный туннель 6in4
6rd from DHCPv4 (Option 212)=6rd из DHCPv4 (Опция 212)
6RD IPv4 Mask Length=6RD IPv4 Mask Length
6rd Prefix Length=Длина префикса 6rd
6rd Relay=6rd Relay
6rd Routed Prefix=Марш. префикс 6rd
6RD Tunnel Border Relay (IPv4 Address)=6RD Tunnel Border Relay (IPv4 Address)
6to4 Anycast Relay=6to4 Anycast Relay
802.11n Preamble=Преамбула 802.11n
About=О системе
about 60 seconds=около 60 сек.
about&nbsp;=около&nbsp;
About TomatoAnon Project=О проекте TomatoAnon
Absolute maximum amount of time allowed for any DHCP lease to be valid=Максимальное время аренды адреса DHCP
Acceptable=Нормальный
Accept DNS configuration=Получить конфигурацию DNS
Accept RA from=Принимать RA из
Access=Доступ
Access Level=Уровень доступа
Access Point=Точка доступа
Access Point + WDS=Точка доступа + WDS
Access Restriction=Ограничения доступа
Access Restriction Overview=Ограничения доступа - обзор
Access Restrictions=Ограничения доступа
Action=Действие
active=активен
Active=Активен
actual max depends on Country selected; use 0 for hardware default=Максимальные значения зависят от выбранного региона; 0 для значений по умолчанию
Adaptive=Адаптивно
Adblock=AdBlock
Adblock Settings=Настройки AdBlock
Add=Добавить
Add DNS servers received from your WAN connection to the static DNS server list=Добавляет DNS-серверы, полученные от провайдера на WAN-интерфейсе, к списку постоянных DNS-серверов
added=добавлено
Additional=Дополнительно
Additional Shares List=Список дополнительных общих папок
Address=Адрес
Addresses must be unique=Адрес не должен совпадать с другими
Address must be supplied when ConnectTo is checked=Необходимо указать адрес, если отмечена настройка «Подкл.К»
Address to be used at the local end of the tunnelled PPP links between the server and the VPN clients=Этот адрес будет использоваться на локальной стороне PPP-соединений между сервером и VPN-клиентами
Admin=Администратор
Admin Access=Управление и доступ
Administration=Администрирование
Admin Restrictions=Ограничения админ. доступа
Advanced=Расш. настройки
Advanced DHCP/DNS=Расширенные настройки DHCP/DNS
Advanced Settings=Расширен. настройки
Advanced Tomato=Advanced Tomato
Advertise DNS to clients=Отправлять DNS клиентам
Advised to turn off PIN Code=Рекомендуется отключить PIN-код
a few more seconds=ещё несколько секунд
Africa=Африка
Afterburner=Afterburner
After configuring this VIF, review and save your settings on the Overview tab=После создания этого соединения, проверьте и сохраните настройки на вкладке Состояние роутера
After flashing, erase all data in NVRAM memory=Очистить содержимое NVRAM после обновления
after saving settings and rebooting your router= после сохранения настроек и перезагрузки роутера
All=ВСЕ
All Computers / Devices=Все устройства
All Day=Весь день
All Except=Все кроме
All IPP2P filters=Все типы IPP2P
All IPP2P Filters=Фильтровать все IPP2P
All Media Files=Все медиа-файлы
Allow Admin Login=Разрешить админ. авторизацию
Allow Anyhost to access=Доступ с любого адреса
Allow Client<->Client=Разрешить Клиент<->Клиент
Allow dnsmasq to be your DNS server on LAN=Разрешить dnsmasqвыполнять функции DNS-сервера в LAN
Allowed any hosts to access database server=Разрешает любым компьютерам подключаться к серверу БД
Allowed Remote=Разрешено для
Allow Only These Clients=Разрешить только этих клиентов
Allow Only User/Pass(Without cert) Auth=Разрешить вход с паролем без сертификатов
Allow Password Login=Разрешить доступ с паролем
Allow remote access=Разрешить удаленный доступ
Allow Remote Access=Разрешить удаленный доступ
Allows configuring extra WINS servers for VPN clients, in addition to the WINS server defined on=Позволяет определить дополнительные серверы WINS для VPN-клиентов, помимо указанного на странице
Allows defining DNS servers manually (if none are set, the router/local IP address should be used by VPN clients)=Позволяет задать серверы DNS (если не указаны, будет использоваться локальный IP-адрес роутера)
Allows overriding 'traditional' VLAN/VID mapping with arbitrary VIDs for each VLAN=Позволяет переопределить VLAN/VID назначения указанными VID для каждого VLAN
Allows users to connect with admin account=Позволяет пользователям подключаться с административными правами
Allow User/Pass Auth=Разрешить авторизацию Пользователь/Пароль
Allow web login as=Разрешить веб-доступ как
Allow Wireless Access=Доступ по Wi-Fi 
all ports=все порты
All queries to dnsmasq will be logged to syslog=Все запросы к dnsmasq будут записаны в журнал
Alpha=Alpha
always enabled for Admin=Всегда включено для администратора
Amber=Янтарный
Amplifier=Усилитель
and=и
and any integer up to 9 (best zlib), 10 (fast lzo) and 11 (best lzo)=а так же любое целое до 9 (zlib макс) 10 (lzo быстро) и 11 (lzo макс)
and Broadcom Wireless Driver=и драйвер Broadcom Wireless
and make a choice=и сделайте свой выбор
and packet signing=с подписью пакетов
and spaces are allowed=и пробелы
Announce IPv6 on LAN (DHCP)=Анонсировать IPv6 в LAN (DHCP)
Announce IPv6 on LAN (SLAAC)=Анонсировать IPv6 в LAN (SLAAC)
Anonymous Root Directory=Анонимная корневая директория
Anonymous Users Access=Анонимный доступ
An upgrade may overwrite the JFFS partition currently in use. Before upgrading, please backup the contents of the JFFS partition, disable it, then reboot the router=Обновление может повредить раздел JFFS. Пожалуйста, сохраните содержимое JFFS, отключите её в настройках и перезагрузите роутер. После этого вы сможете обновить прошивку
any=любой
Any=Любой
Any Address=Любой адрес
Any DNS requests/packets sent out to UDP port 53 are redirected to the internal DNS server=Любые DNS-запросы, пришедшие на порт UDP 53, будут отправлены на встроенный DNS-сервер
Any Port=Любой порт
Any Protocol=Любой протокол
APCUPSD integration and GUI=APC UPS + GUI
APC UPS Response=Ответ от APC UPS
APC UPS Status=Состояние APC UPS
AP Isolation=Изоляция AP
AppleJuice=AppleJuice
Application=Приложение
Applies To=Применимо к
Apr=Апр
aprox. size that can be buffered completely in RAM=Приблизительное свободное место в RAM, доступное для загрузки обновления
APSD Mode=Режим APSD
are=
area=разделе
are allowed=разрешены
are not allowed=не разрешены
Are you sure?=Вы уверены?
Are you sure the file=Вы уверены, что файл
Are you sure you want to upgrade using=Вы дейтвительно хотите обновить прошивку на
ASCII characters=Символы ASCII
Asia=Азия
Assigned / Routed Prefix=Назначенный / марш. префикс
Assignments of wireless interfaces to different LAN briges. You should probably be using and/or check things on=Назначение Wi-Fi интерфейсов различным мостам LAN. Вам так же стоит проверить/изменить настройки в разделах
Assured=Assured
as you can find in USB mount path=для папки, находящейся на USB-диске
at any time=единовременно
At least one NTP server is required=Необходимо указать хотя бы один сервер времени
Attached Devices=Подключенные устройства
Attention=Внимание
Attention! Must not use NAND for datadir and tmpdir=Внимание! Не используйте NAND для директории с данными и временной директории
Audio only=Аудио
Aug=Авг
Authentication is=Авторизация
Authentication required=Требуется авторизация
Authentication Type=Тип авторизации
Authorization Mode=Авторизация
Authorized Keys=Авторизованные ключи
Auto=Авто
Auto Daylight Savings Time=Автоматический переход на летнее / зимнее время
Auto Expire=Авто-удаление
Automatic=Автоматически
automatically include new IPs in monitoring as soon as any traffic is detected=автоматически добавлять новые адреса при появлении трафика
Automatically mount all partitions to sub-directories in=Автоматически подключать все разделы как поддиректории в
Automatically retrying in=Автоматически повторить через
Automount=Авто-монтирование
Auto Refresh=Авто-обновл.
Auto refresh every=Автообновление через
Auto resolve addresses=Авто-определение имен
Auto-share all USB Partitions=Автомат. открывать доступ ко всем USB-дискам
Auto Update Time=Интервал обновления
Autoupdate will be launch on 1:00AM every day=Авоотбнвление ежедневно в 1 ночи
available entries=позиций 
available, total=доступно, всего
avg=среднее
Avg=Avg
Avoid displaying LAN to router connections=Избегать отображения LAN в списке соединений роутера
Avoid performing an NVRAM commit=Предотвращать запись в NVRAM
Avoid using this option when FTP server is enabled for WAN. IT PROVIDES FULL ACCESS TO THE ROUTER FILE SYSTEM=Избегайте использования этой опции, если сервер доступен из Интернета.<br>&nbsp;&nbsp;&nbsp;ОНА ОБЕСПЕЧИВАЕТ ПОЛНЫЙ ДОСТУП К ФАЙЛОВОЙ СИСТЕМЕ РОУТЕРА
Back=Назад
Backup=Сохранить
Backup Configuration=Сохранить настройки
Backup Directory=Директория для бэкапа
Backup MX=Резервный MX
Bad id=Плохой ID
Bad id=Неверный ID
Bandwidth=Загрузка сети
Bandwidth Distribution=Распределение по трафику
Bandwidth Distribution (Inbound)=Распределение по входящему трафику
Bandwidth Distribution (Outbound)=Распределение по исходящему трафику
Bandwidth Limiter=Ограничения скорости
Bandwidth Limiter for=Ограничения скорости для
Bandwidth Monitoring=Загрузка сети
Bandwidth monitoring disabled=Монитор загрузки сети отключен в настройках
Based on Tomato Firmware=Основано на прошивке Tomato
Basic=Основные настройки
Basic IPv6=Основные настройки IPv6
Basic Rate=Базовая скорость
Basic Settings=Основные настройки
Beacon Interval=Интервал маяка
be assigned to WAN=был назначен для WAN
before amplification=до усиления
before amplification=до усиления
Before disconnecting 3G Modem from USB port, remember to uncheck box. If modem used usbserial module, you have to reboot router before unplug modem=Перед отключением 3G-модема из USB-порта, выключите эту настройку. Если модем использует модуль usbserial, необходимо будет выполнить перезагрузку роутера
Be patient. Starting the TOR client can take from several seconds to several minutes=Наберитесь терпения. Для запуска клиента TOR может потребоваться от нескольких секунд до нескольких минут
be selected as the default=был выбран по умолчанию
Best lzo=lzo макс.
Best Regards=С наилучшими пожеланиями
Best zlib=zlib макс.
Beta=Beta
Bi-directional=Би-директ
Bidirectional copying=Копирование в обоих направл.
big thanks for=большое спасибо
BitTorrent Client=Клиент BitTorrent
Black=черный
Blacklist Custom=Свой черный список
Blacklisted domains=Имена в черном списке
Blacklist URL=URL черного списка
Block All Internet Access=Отключить доступ в Интернет
Blocked Resources=Запрещенные ресурсы
Blocklist=Черный список
Block the following clients=Блокировать адреса из списка
Blue=синий
Bluetooth Coexistence=Bluetooth Coexistence
Boot Wait Time=Пауза при загрузке
Both=ВСЕ
Both MAC address and name fields must not be empty=Поля MAC и Имя должны быть заполнены
Both passwords must match=Пароли должны совпадать
Bound to=ARP
Bridge=Мост
Bridge/Auto Switch=Мост/Авто-свитч
Bridge br0 must be always defined and have a valid IP address set=Мост br0 существует всегда и должен иметь действительный IP-адрес
Bridge TAP with=Подключить TAP к мосту
Bridge WAN port to primary LAN=Подключить порт WAN к основной локальной сети
Broadcast=Широковещание SSID
Broadcast Relay Mode=Режим широковещания
Built on=Дата компиляции
Builtype. Ex=Тип сборки. Пример
but might be=однако могут быть
Buttons=Кнопки
Buttons / LED=Кнопки / Индикаторы
bwlimit=bwlimit
BW Limiter=Огранич. скорости
By definition, configuration settings for the=Настройки
bytes=байтов
Bytes=Байт
Bytes In=Получено,&nbsp;Байт
Bytes Out=Отправлено,&nbsp;Байт
by the WL driver=WL-драйвером
called when any USB device is attached or removed=вызывается при подключении и отключении устройств
Cancel=Отмена
Cannot add another entry for bridge br=Невозможно добавить новое устройство к мосту br
Cannot add more than one entry with VID=Не возможно добавить более одного значения с VID
Cannot proceed: at least one user must be defined=Невозможно продолжить: минимум один пользователь должен быть выбран
Cannot proceed: one and only one VID must be assigned to the primary LAN=Не возможно применить: только один VID должен быт назначен для основной сети LAN
Cannot proceed: one VID must be assigned to WAN=Не возможно применить: как минимум 1 VID должен быть задан для WAN
Cannot proceed: two or more LAN bridges have conflicting IP addresses or overlapping subnets=Не возможно применить: два или более моста имеют конфликтующие адреса или пересекающиеся подсети
Cannot proceed without setting a default VID=Не возможно применить без установки VID по умолчанию
Cannot push routes if they`re not given. Please provide subnet/netmask=Невозможно отправить маршруты. Укажите subnet / netmask
Cannot set=Не возможно установить
Cannot upgrade if JFFS is enabled=Обновление не возможно при включенной JFFS
Capabilities=Возможности
Captive Portal=Wi-Fi Портал
Captive Portal. (Based in NocatSplash)=Wi-Fi Портал (основан на NocatSplash)
Captive Portal Management=Настройка Wi-Fi портала
Captive Site Forwarding=Перенаправление Wi-Fi Портала
Caution!=Внимание!
Ceiling must be greater than or equal to rate=Ceiling должен быть больше или равен Rate
Central / Eastern Europe=Центральная/Восточная Европа
Certificate Authority=Центр Сертификации (CA)
Ch=Канал
Changes Saved=Изменения сохранены
Channel=Беспроводной канал
Channel Width=Ширина канала
character=символ
character. IP range is not supported=символ. Диапазоны IP не поддерживаются
characters=знаков
characters. Only one IP or Domain per entry=символы. Допускаются один IP или домен на строку
characters or less=или менее
Check alive every=Проверять каждые
Check connections every=Проверка соединения
Check for ISP's that require only a Prefix Delegation (usually PPPoE (DSL,Fiber) connections)=Для операторов, требующих только Prefix Delegation (обычно, на PPPoE соединениях)
check in case PPTP/L2TP/PPPoE connection with DHCP MAN=включите для PPTP/L2TP/PPPoE соединения c DHCP MAN
Checkout my router=Отметить мой роутер
Chipset=Архитектура
CIFS Client=Клиент CIFS
Class=Класс
Classification=Классификация
Cleaning Interval=Интервал очистки
Cleaning Threshold=Порог очистки
Clear=Очистить
Clear Cookies=Очистить Cookies
Clear Data After Backup=Удалить данные после сохранения
Click here to hide=скрыть
Click here to manage MySQL=Кликните для управления MySQL
Click here to open Transmission GUI=Открыть веб-интерфейс Transmission
Click here to read more=Нажмите здесь для получения подробной информации
Click here to show=показать
Click OK/Login=Выберите «OK/Войти»
Click/select a device from this list to hide it=Выберите устройство из списка для скрытия
Click/select to show it again=Выберите для отображения на графике
Click to delete=Нажмите для удаления
Click to edit=Нажмите для редактирования
Click to wake up=Нажмите для пробуждения
Client=Клиент
Client address pool=IP-пул клиентов
Client Certificate=Сертификат ктиента
Client Codepage=Кодировка клиента
Client is not running or status could not be read=Клиент не запущен, или статус не может быть определен
Client Key=Ключ клента
Client List=Список клиентов
Clone PC=Скопировать адрес компьютера
Close=Close
Close Wait=Close Wait
Color=Цвет
Color Scheme=Цветовая схема
Comcast DSCP Fix GUI=Comcast DSCP + GUI
Command=Команда
comma separated list=разделено запятыми
Comma separated list=список, разделенный запятыми
Common Name=Имя (CN)
Common name cannot contain=CN не может содержать
Common name is mandatory=CN - обязательный параметр
compatible browsers may also exist=совместимые браузеры так же существуют
Comprehensive QOS rule examples set by default=Набор преднастроенных правил QoS
Compression=Сжатие
Computer's MAC Address=MAC-адрес компьютера
Config=Конфигурация
Configurable QOS class names=Настаиваемые имена классов QoS
configuration=конфигурация
Configuration=Конфигурация
Configure=Настроить
conflicts/overlaps with another LAN bridge=Конфликт/пересечение с другим мостом LAN
Connect=Подкл.
Connection Logging=Журнал сетевых соединений
Connection retry=Повтор подключения
connections=соединен.
Connections=Соединения
connections currently tracked=соединен. в настоящий момент
Connections Distribution=Распределение по соединениям
Connection Type=Тип соединения
Connection Uptime=Длительность
Connect Mode=Режим соединения
Connect On Demand=По требованию
ConnectTo=Подкл.к
Conntrack / Netfilter=Соединения / NAT
Console log level=Уровень сообщений журнала
Contact=Конакт
Content Filter=Фильтр содержимого
Continue=Продолжить
Control Sideband=Основной канал
Cookies Cleared=Cookies очищены
Copyright=Copyright
Core USB Support=Поддержка USB
Correct file format: 0.0.0.0 domain.com or 127.0.0.1 domain.com, one domain per line=Правильный формат: 0.0.0.0 microsoft.com or 127.0.0.1 porno.net, один домен на строку
Count cache memory and buffers as free memory=Считать память кеша и буферов как свободную
count current=показать текущие
Country / Region=Страна / Регион
CPU Freq=Частота процессора
CPU Load=Загрузка
CPU Usage=Использование ЦПУ
Create Backups=Создать резервную копию
Create NAT on tunnel=Создать правила NAT
Create New File=Создать новый файл
Cron=События Cron
CTS Protection Mode=Защита CTS
Current DNS=Текущий DNS
Current Routing Table=Текущая таблица маршрутов
Current Version=Текущая версия
Custom=Пользовательский
Custom configuration=Конфигурация пользователя
Custom Configuration=Конфигурация пользователя
Custom IP address=Пользоват. IP-адрес
Custom IP Address=Пользоват. IP-адрес
Customized Splash File=Настраиваемый splash-файл
Custom log file path=Путь к файлу журнала
Custom Log File Path=Путь к файлу журнала
Custom Path=Путь к файлу
Custom Script=Скрипт пользователя
Custom TZ String=Параметр TZ
Custom URL=URL пользователя
Cut-Through Forwarding=Аппаратный NAT
Cyrillic / Russian=Кириллица / Русский
Daily=По дням
Daily Backup=Ежедневный бэкап
Daily History=История за день
Data=Данные
Data and tmp dir.=Директория для данных и временных файлов
Data and tmp dir.=Директория с data и tmp
Database Location=Расположение БД
Data current as of=Данные по состоянию от
Data dir.=Директория с данными
Data Directory=Директория с данными
Date=Дата
Date Format=Формат даты
Date Range=Диапазон данных
days=дней
Days=Дни
DDNS=Сервис DDNS
DDNS update is running. Please refresh after a few seconds=Производтся обновление DDNS，обновите старницу через несколько секунд
Debug=Отладка
Debugging=Отладка
Debug Mode=Режим отладки
Dec=Дек
default=по умолчанию
Default=По умолчанию
Default class=Класс по умолчанию
Default Class=Класс по умолчанию
Default Class for=Класс по умолчанию для
Default Class for unlisted MAC / IP's in=Класс по умолчанию для
Default Gateway=Шлюз по умолчанию
default (random) set=по умолчанию (произвольно) выбран
Delay at startup=Пауза при загрузке
Delete=Удалить
Delete All=Удалить все
Delete all entries?=Удалить все значения?
Delete Lease=Удалить устройство
Delete this rule?=Удалить это правило?
deleting=удаление
Description=Описание
Dest Address=DST-адрес
Destination=Назначение
Destination Address=Адрес назначения
Destination address inside the LAN=Адрес назначения в локальной сети
Destination Interface=Сеть назначения
Destination LAN bridge=Мост назначения LAN
Dest Ports=DST-порты
Details=Статистика
Determines if this VLAN ID should be treated as WAN, part of a LAN bridge or just left alone (i.e. member of a 802.1Q trunk, being managed manually via scripts, etc...)=Определяет, должен ли данный VLAN ID быть отнесен к WAN, мосту LAN или оставлен как есть (например, он является частью 802.1Q транка, обрабатываемого отдельным ПО/скриптом и т.д.)
Device List=Устройства
DHCP Client=DHCP-клиент
DHCPC Options=Опции DHCP-клиента
DHCP / DNS=DHCP / DNS
DHCP / DNS Server=Сервер DHCP / DNS
DHCP Routes=Маршруты DHCP
DHCPv6 with Prefix Delegation=DHCPv6 с делегацией префикса
DHCP will use the IP address of the router as the default gateway on each LAN=DHCP будет использовать адрес роутера как шлюз по умолчанию для клиентов в LAN
Diffie Hellman parameters=Параметры Diffie Hellman
Direct clients to=Указывать клиентам
Directories=Директории
directory=директория
Directory=Директория
directory is shared in Read Only mode=доступна только для чтения
Directory Listings=Список каталогов
Directory name under mounted partition=Название поддиректории
Directory with GUI files=Директория с файлами GUI
disable=отключить
Disable=Отключить
Disable all LEDs=Отключить все индикаторы
disabled=отключен
Disabled=Откл.
Disabled for Anonymous=Отключено для анонимных пользователей
Disabled (recommended)=Отключено (рекомендуется)
Disable filter=Отключить фильтр
Disable Wireless=Отключить Wi-Fi
Disconnect=Отключить
Disconnecting=Отключение
Display=График
Distance / ACK Timing=Расстояние / задержка ACK
DLCeil=DL&nbsp;Ceil
DLCeil must be greater than DLRate=DL Ceil должен быть больше чем DL Rate
DLCeil must between 1 and 99999=DL Ceil должен быть между 1 и 99999
DL Rate=DL-Rate
DLRate=DL&nbsp;Rate
DLRate must between 1 and 99999=DL Rate должен быть между 1 и 99999
DMZ=DMZ
DNScrypt-proxy 1.4.0 integration and GUI=DNScrypt-proxy 1.4.0 + GUI
DNSCrypt-Proxy selectable/manual resolver=Выборочный DNSCrypt-Proxy
Dnsmasq will ignore DHCP requests to Only MAC addresses listed on the=Dnsmasq проигнорирует DHCP-запросы для MAC-адресов не из списка на странице
Dnsmasq will ignore DHCP requests to Only MAC addresses listed on the=Dnsmasq проигнорирует DHCP-запросы для MAC-адресов не из списка на странице
DNS Port=Порт DNS
DNSSEC integration and GUI=DNSSEC + GUI
DNS Server=Сервер DNS
DNS Servers=Серверы DNS
Document Root Path=Путь к корневой директории
Domain=Домен
Domain Name=Домен
Domains=Домены
Do Nothing=Нет действий
Do not interrupt this browser or the router=Не закрывайте браузер и не отключайте роутер
Do not restart the following process if they die=Не перезапускать эти процессы после их завершения
Down=Выкл.
Download=Загрузить
Download ceil=DL&nbsp;Ceil
Download CFE=Загрузить CFE
Download directory=Директория для загрузки
Downloaded=Получено
Download Ip6tables Dump=Загрузить конфигурацию ip6albes
Download Iptables Dump=Загрузить конфигурацию iptables
Download limit=Ограничение скорости загрузки
Download Log File=Сохранить файл журнала
Download Logs=Загрузить журнал
Download NVRAM Dump=Загрузить содержимое NVRAM
Download rate=DL&nbsp;Rate
Downloads queuing=Очередь загрузок
Do you know what TomatoAnon doing=Знаете ли вы, для чего нужет TomatoAnon
Do you want enable TomatoAnon=Вы хотите включить TomatoAnon
Do you want enable TomatoAnon=Вы хотите включить TomatoAnon
D Port=DST-порт
Drop Idle=Сбросить неактивные
DSCP value=Значение DSCP
DSCP Value=Значение DSCP
DSL Overhead Value - ATM Encapsulation Type=DSL - тип инкапсуляции ATM
Dst=DST
Dst Address=DST-адрес
Dst IP=DST IP
dst port=dst-порт
Dst Port=DST-порт
DTIM Interval=Интервал DTIM
Dual-band and Wireless-N mode=Поддержка 2-х диапазонов Wi-Fi
Duplicate hostname=Это имя хоста уже используется
Duplicate IP address=Такой IP-адрес уже существует
duplicate IP or MAC address=IP или MAC уже используется
Duplicate MAC address=Такой MAC-адрес уже существует
Duplicate share name=Имя уже используется
Duplicate User=Скопировать пользователя
Duplicate user name=Скопировать имя
During this period of time no Welcome banner will appear when you access to the device=Период времени, в течение которого отображается баннер при подключении
Dynamic DNS=Динамический DNS
Ed25519 Private Key=Приватный ключ Ed25519
Ed25519 Private Key is required when Start With WAN is checked=Необходимо указать приватный ключ Ed25519, если отмечена настройка «Запускать вместе с WAN»
Ed25519 Public Key=Публичный ключ Ed25519
Ed25519 Public Key is required=Необходимо указать публичный ключ Ed25519
Edges=Edges
Edit Access Restrictions=Изменение правил огр. доступа
Efficient Multicast Forwarding=Оптимизация мультикаста
Either both or neither subnet and netmask must be provided=Либо ни одного, либо оба параметра subnet / netmask должны быть указаны
Email Address=Email
empty field means=пустое поле означает
Empty share name is not allowed=Необходимо указать имя
Enable=Включить
Enable 802.1Q tagging of ethernet frames on a particular port/VLAN=Включить тегирование 802.1Q на определенном порту/VLAN
Enable at Startup=Включить при загрузке 
Enable Auto-Discovery=Включить авто-обнаружение
Enable client statistics=Включить статистику
Enable cprintf output to console=Включить вывод cprintf в консоль
Enable cprintf output to /tmp/cprintf=Включить вывод cprintf в /tmp/cprintf
Enabled=Вкл.
Enable DDNS output to=Включить вывод сообщений DDNS в
Enable DMZ=Включить DMZ
Enable DNS rebinding protection on Dnsmasq=Включить защиту от атак DNS rebind для Dnsmasq
Enable DNSSEC=Включить DNSSEC
Enabled on=Включено для
Enable DSCP Fix=Включить DSCP Fix
Enable Encryption=Включить шифрование
Enable File Sharing=Включить доступ к файлам
Enable FTP Server=Включить FTP-сервер
Enable function=Включить функцию
Enable Function=Включить Портал
Enable GUI=Включить GUI
Enable IGMPproxy=Включить IGMPproxy
Enable Interface=Включить интерфейс
Enable Jumbo Frames=Вкл. Jumbo Frames
Enable Limiter=Включить ограничения скорости
Enable MySQL server=Включить сервер MySQL
Enable NAT-PMP=Включить NAT-PMP
Enable NFS Server=Включить NFS-сервер
Enable PHP support=Включить поддержку PHP
Enable Ports State=Показывать состояние
Enable Server on Start=Запускать при загрузке
Enable SNMP=Включить SNMP
Enable SYN cookies=Включить SYN Cookies
Enable TCP Vegas=Включить TCP Vegas
Enable this option if you need more than one NAS process running=Включите, если необходимо более одного NAS
Enable TOR=Включить TOR
Enable torrent client=Включить BT (Transmission)
Enable Udpxy=Включить Udpxy
Enable UPnP=Включить UPnP
Enable USB Partition=Подключить раздел
Enable Wireless=Включить Wi-Fi
Enabling this option will turn on VPN channel encryption, but it might lead to reduced channel bandwidth=Включение этой опции обеспечит шифрование VPN-соединений, но может снизить их пропускную способность
Encryption=Шифрование
Encryption cipher=Шифрование
Enforce static ARP binding of this particular IP/MAC address pair=Создать постоянную ARP-запись для этого IP/MAC
English=Английский
Enhanced RX Sensitivity=Улучшенная чувствительность приёма
erase all data in NVRAM memory, and reconfigure the router manually=очитстить все значения в NVRAM и заново настроить роутер
Erase all data in NVRAM memory (thorough)=Очистить содержимое раздела NVRAM (полная очистка)
Error=Ошибка
ERROR=ОШИБКА
Established=Установленные
Ethernet Ports State=Порты Ethernet
Europe=Европа
Events Logged=События в журнале
every=каждые
Every=Каждые 
Every 12 hours=Каждые 12 часов
Every 12 hours=Каждые 12 часов
Every 12 Hours=Каждые 12 часов
Every 15 minutes=Каждые 15 минут
Every 1 Day=Каждый день
Every 1 Hour=Каждый час
Every 24 hours=Каждые сутки
Every 24 hours=Каждые 24 часа
Every 24 Hours=Каждые 24 часа
Every 2 Days=Каждые 2 часа
Every 2 hours=Каждые 2 часа
Every 2 Hours=Каждые 2 часа
Every 30 minutes=Каждые 30 минут
Every 30 Minutes=Каждые 30 мин.
Every 3 Days=Каждые 3 часа
Every 3 Hours=Каждые 3 часа
Every 3 minutes=Каждые 3 минуты
Every 4 Days=Каждые 4 часа
Every 4 hours=Каждые 4 часа
Every 4 Hours=Каждые 4 часа
Every 5 Days=Каждые 5 часов
Every 5 Hours=Каждые 5 часов
Every 5 minutes=Каждые 5 минут
Every 6 Days=Каждые 6 часов
Every 6 hours=Каждые 6 часов
Every 6 Hours=Каждые 6 часов
Every 7 Days=Каждую неделю
Every 8 hours=Каждые 8 часов
Every 9 Hours=Каждые 9 часов
Everyday=Каждый день
every day at midnight=каждый день в полночь
Every hour=Каждый час
Every Hour=Каждый час
Every minute=Каждую минуту
Every Week=Каждую неделю
ex=например
Ex=Пример
Example=Пример
Examples=Примеры
Excluded/Included ports to be redirected=Исключенные/Разрешенные порты для перенаправления
Excluded Interfaces=Исключить интерфейсы
Excluded IPs=Исключенные IP-адреса
Excluded Ports to be redirected=Список запрещенных портов
Exclude from List=Исключить из списка
Exclude gateway traffic=Исключить трафик маршрутизатора
Exclude INTERNET LED=Не отключать индикатор «Интернет»
Exclude IPv4 broadcast=Исключить IPv4 броадкаст
Exclude IPv4 multicast=Исключить IPv4 мультикаст
Exclude these IPs=Исключить IP
Exclusive=Эксклюзивно
Execute=Выполнить
Execute System Commands=Выполнить команды
Execute When Mounted=Выполнять при подключении
Expecting a=Ожидается
Expecting a list of ports or port range=Ожидается список портов или диапазон
Expecting a URL -- http://... or https://...=Ожидается URL -- http://... или https://...
Experts Only=Экспертный режим
Expired time where you can't access the device again=Длительность сессии, после которого доступ будет закрыт
Expire Scheduled=Expire Scheduled
Exports=Exports
Extended MOTD=Расширенный MOTD
Extended Sysinfo=Расширенная информация о системе
External=Внешний
External Only=Только External
Ext Ports=EXT-порты
Extra HMAC authorization=Авторизация HMAC
Extra options for the DHCP client=Дополнительные параметры для DHCP-клиента
Extra options to be added to the Dnsmasq configuration file=Дополнительные опции Dnsmasq
Failed to mount. Verify the device is plugged in, and try again.=Ошибка подключения! Проверьте, что диск вставлен в порт USB, и попробуйте снова.
Failover=Резервирование
fast=быстро
Fast lzo=lzo быстро
Fast zlib=zlib быстро
feature=
features=
Feb=Фев
few ports=несколько портов
file=файл
File Sharing=Доступ к файлам
File Systems Support=Файловые системы
Filter out this address=Фильтровать этот адрес
Filter out this IP=Фильтровать по этому IP
Filters=Фильтры
Find=Найти
Find more peers using=Поиск пиров с помощью
FIN Wait=FIN Wait
Firewall=Брандмауэр
Firewall Rules=Правила брандмауэра
Firmware Upgrade=Обновление прошивки
first=первый
First 802.1Q VLAN tag=Первый 802.1Q VLAN тег
First Day Of The Month=Первый день месяца
Fixed wireless channel required in WDS mode=Фиксированный канал необходим для режима WDS
Fixes Comcast incorrect DSCP=Исправления для Comcast DSCP
Flash Size=Размер флеш-памяти
for anonymous connections=для анонимных подключений
for authenticated users access, if not specified for the user=для авторизованных пользователей, если не определено для пользователя
for authenticated users access in private mode=для авторизованных пользователей в приватном режиме
Force next update=Принудительно обновить
for default=для умолчаний
for DHCP=для DHCP
For help generating keys, refer to the OpenVPN=Для справки посетите сайт OpenVPN
for IP 192.168.1.4 to 192.168.1.7=для IP от 192.168.1.4 до 192.168.1.7
for IP Range .4 to .7=для диапазона IP .4 до .7
Format / Erase=Форматировать / Стереть
Format the JFFS partition?=Форматировать раздел JFFS?
for one IP=для одного IP
Forwarded Only=Только Forwarded
Forwarded Ports=Открытые порты
Forwarded Ports=Открытые порты
Forwarded Ports are the WAN to LAN ports that are opened if the 'trigger' is activated=Открытые порты - это порты, открытые из WAN в LAN в случае активности порта-триггера
Forwarding=Forwarding
Forward only if from this address. Ex=Перенаправлять только с этого адреса(ов). Пример
Fragmentation Threshold=Порог фрагментации
Frame Burst=Frame Burst
free=свободно
Free Memory=Свободно в памяти
Frequent saving to NVRAM or JFFS2 is not recommended. Continue anyway?=Не рекомендуется частая запись в NVRAM или JFFS2. Все равно продолжить?
Fri=Пт
Friday=Пятница
From=От
From Source IP=От SRC IP
FTP Port=Порт для FTP
FTP Server=FTP-сервер
FTP Server Configuration=Конфигурация FTP-сервера
Full=Полностью
Full-Duplex=FD
Gamma=Gamma
Gateway=Шлюз
Gateway Name=Название Портала
Gateway / Next Hop=Шлюз
Gateway Port=Порт шлюза
General Statistics=Общая статистика
Generate=Создать
Generate Keys=Генерировать ключи
Generate Marker=Создавать маркер
Generic=Generic
Global peer limit=Общий лимит соединений
Global Tunnel ID=Глобальный ID туннеля
GPT support for HDD by Yaniv Hamo=HDD с GPT-таблицей от Yaniv Hamo
Gray=серый
Green=зеленый
GRE / PPTP=PPTP / GRE
Group Key Renewal=Обновление ключа
GUI for Transmission=GUI для Transmission
GUI will prompt for user/pass=GUI будет запрашивать имя пользователя/пароль
Half-Duplex=HD
Hash Table Size=Размер хэш-таблицы
Have you modified the configuration file manually? Tick this box and changes will be maintained=Вы недавно изменили файл конфигурации вручную? Отметьте этот параметр, и изменения в них будут учтены
HDD Spindown=Остановка HDD
header=заголовок
Hello=Здравствуйте
Here you can upload your personal Welcome banner that will overwrite the default one=Здесь вы можете загрузить собственный баннер и перезаписать используемый по умолчанию
hex or=HEX или
HFS/HFS+ Driver=Драйвер HFS/HFS+
HFS / HFS+ filesystem integration=Поддержка HFS / HFS+
Hidden=Скрыто
Hidden addresses=Скрытые адреса
Hidden Read / Write=Скрыто (чтение/запись)
hide=скрыть
Hide=Скрыть
Hide IPs without traffic=Не показывать IP без трафика
High=Высокий
Highest=Высший
highly recomended=крайне рекомендуется
history=история
Homepage=Домашняя страница
Home Page=Домашняя страница
Host=Хост
host-down=host-down
Hostname=Имя хоста
Host Name=Имя хоста
Hostname / Group=Имя хоста / Группа
Host Name is required=Необходимо указать имя хоста
Host Name is required when Start With WAN is checked=Необходимо задать имя хоста, если отмечена настройка «Запускать вместе с WAN»
Host or IP Address / Port=Имя или IP-адрес / Порт
hosts=устр.
Hosts=Hosts
host-up=host-up
Hotplug script=Скрипт при подключении
hour=час
Hours=Часы
HOWTO=HOWTO
HTTP Port=Порт HTTP
HTTP Request=HTTP-запрос
HTTP Requested Files=Файлы HTTP
HTTP Section=Раздел HTTP
HTTPS Port=Порт HTTPS
Human-readable nickname/label assigned to this device on the network=Псевдоним/метка для этого устройства в сети
Identification=Идентификация
Idle Timeout=Таймаут соединения
i.e. to handle WPAx encryption on more than one WLVIF=например, для обеспечения шифрования WPAx на нескольких виртуальных интерфейсах Wi-Fi
i.e; USB Stick, Hard Drive or SSD=как например USB флеш диск, жесткий жиск или SSD
If Allowed By Firewall=Разрешенные
If Blocked By Firewall=Заблокированные
If checked, privileges table will be forced to re-initialize by mysql_install_db=Если выбрано, таблицы привилегий будут пересозданы с помощью mysql_install_db
If checked, root password will be forced to re-initialize=Если выбрано, пароль пользователя root будет пересоздан
If enabled, mysqld will be checked at the specified interval and will re-launch after a crash=Если включено, mysqld будет проверяться с заданным интервалом и перезапускаться в случае аварийного завершения
If enabled, this option will limit how many torrents can be downloaded at once=Если включена, эта опция определяет, сколько торрентов может загружаться одновременно
If enabled, this option will limit how many torrents can be uploaded/seeded at once=Если включена, эта опция определяет, сколько торрентов может раздаваться одновременно
If enabled, transmission-daemon will be checked at the specified interval and will re-launch after a crash=Если включено, transmission-daemon будет проверяться с указанным интервалом времени, и будет перезапущен в случае аварийного завершения
If this VIF should be active and brought online=Если этот вирутальный интерфейс должен быть активен
If you don't agree with this script, or do not wish to use it, you can simply disable it=Если вы не хотите использовать данный скрипт, вы можете просто его отключить
If you notice that the order of the Lan Ports are incorrectly mapped=Если порядок портов не соотвествует фактическому
If your router has only 32MB of RAM, you'll have to use swap=Если у вашего роутера только 32MB RAM - необходимо подключить SWAP
If you want to mount an NFS share from other NFS Server, you can use the mount.nfs tool via telnet/ssh=Для подключения директории другого NFS-сервера вы также можете использовать утилиту mount.nfs в консоли telnet/ssh
Ignore DHCP requests (...)=Игнорировать запросы DHCP (...)
Ignore DHCP requests from unknown devices=Игнорировать DHCP-запросы от неизвестных устройств
Ignore inactive connections=Игнорировать неактивные соединения
Ignore inactive hosts=Скрыть неактивные
Ignore Redirect Gateway=Игнорировать шлюз по умолчанию
Images only=Изображения
I`m not sure right now=Не могу ответить чейчас
implemented by=реализовано
Inactive Rules Cleaning=Очистка устаревших правил
In ARP=В APR-таблице
Inbound=Входящие
Inbound Layer 7=Layer 7 для входящих
Inbound Rates / Limits=Вх. скорость / Ограничения
Included IPs=Включенные IP-адреса
Included Ports to be redirected=Список разрешенных портов
Include Router Brand/Model=Укажите модель роутера
Incoming=ВХ
Incorrect filename. Expecting a=Недопустимый файл. Ожидается
Infinite=Не ограничен
Info=Инфо
Init=Загрузка
in minutes, 0 to disable=в минутах, 0 для отключения
in order to clean up all unused and obsolete entries=для удаления не используемых параметров
IN/OUT=⇊/⇈
In private mode, the root directory is the directory under the 'Private Root Directory' with the name matching the name of the user=В приватном режиме корневой директорией является папка с именем подключенного пользователя внутри «Частной корневой директории»
input like:  param=value   e.g.  connect_timeout=10=значения вида param=value, например: connect_timeout=10
in seconds, -1 for default=в секундах, -1 для умолчаний
in seconds; -1 for infinite=в секундах, -1 — бесконечно
Installed version of Tomato. Ex=Установленная версия Томато. Пример
Int Address=Адрес в LAN
Intercept DNS port=Перекрыть порт DNS
Interface=Интерфейс
Interface mode: Access Point, WDS, Wireless Client, etc=Режим работы: Точка доступа, WDS, Беспроводной клиент и так далее
Interface Status=Состояние
Interface Type=Тип интерфейса
Interference Level=Уровень помех
Interference Mitigation=Снижение интерференции
Internal=Внутренний
Internal Address=Адрес LAN
Internal logging disabled=Ведение журнала отключено
Internet Explorer 5 or better for Windows=Internet Explorer 5 или выше для Windows
In the Download directory (Recommended)=В директории загрузок (рекомендуется)
in this state=в этом состоянии
Int Port=LAN-порт
invalid CIDR notation on IPv6 address=недопустимый CIDR notation для IPv6-адреса
Invalid domain name or IP address=Недействительное имя или IP-адрес
Invalid DSCP value. Valid range=Недопустимое значение DSCP. Ожидается
Invalid DSCP value. Valid range=Недействительное значение DSCP. Допускаются
Invalid entry: max 32 characters are allowed=Недействительное значение: допускается не более 32 символов
Invalid entry. Only characters=Недействительное значение: Разрешены только символы
Invalid filename=Недействительное имя файла
Invalid first IP address or subnet mask=Недопустимый начальный адрес или маска подсети
Invalid hash or URL=Недопустимый хэш или URL
Invalid hostname=Недействительное имя хоста
Invalid hostname/address=Неверное имя/адрес
Invalid hostname. Only characters=Недействительное имя. Допускаются символы
invalid IP address=недопустимый IP-адрес
Invalid IP address=Недопустимый IP-адрес
Invalid IP address or port=Недопустимый IP-адрес или порт
Invalid IP address or subnet mask=Неправильный IP-адрес или маска подсети
invalid IP address range=недопустимый диапазон IP-адресов
Invalid IP address range=Недопустимый диапазон IP-адресов
invalid IPv6 address=недопустимый IPv6-адрес
invalid IPv6 address range=недопустимый диапазон IPv6
Invalid last IP address or subnet mask=Недопустимый конечный адрес или маска подсети
Invalid length. Please enter at least=Неверная длинна. Увеличьте количество символов до как минимум
Invalid length. Please reduce the length to=Неверная длинна. Уменьшите количество символов до
Invalid MAC address=Недопустимый MAC-адрес
Invalid MAC address or IP address/range=Недопустимый MAC / IP / диапазон
Invalid MAC or IP address=Недопустимый MAC или IP-адрес
Invalid name. Only characters=Недействительное имя. Допускаются только символы
invalid netmask=недействительная маска подсети
Invalid netmask=Недействительная маска подсети
Invalid netmask address=Недействительная маска подсети
Invalid number of minutes=Недействительное значение минут
Invalid port=Недопустимый порт
Invalid port range=Недопустимый диапазон портов
Invalid pre-shared key. Please enter at least 8 characters or 64 hexadecimal digits=Недопустимый ключ. Пожалуйста, введите как минимум 8 символов или 64 HEX-знака
Invalid range=Неправильный диапазон
Invalid server address=Недопустимый адрес сервера
Invalid share name. Only characters=Неверное имя! Допускаются только символы
Invalid SSH key=Некорректный ключ SSH
Invalid subnet address=Недействительная подсеть
Invalid Subnet or IP address=Недействительная маска подсети или IP-адрес
Invalid UNC=Не верный UNC
Invalid user name. Only characters=Недействительное имя пользователя. Допустимые символы
Invalid WEP key. Expecting=Недопустимый ключ WEP. Разрешаются
Invert Ports Order=Инвертировать номера
IP address=IP-адрес
IP Address=IP-адрес
IP Address(es)=IP-адрес(а)
IP Address / IP Range=IP-адрес / Диапазон IP
IP address outside of LAN=IP-адрес за пределами адресов LAN
IP Address/Subnet=IP-адрес/Подсеть
IP | IP Range | MAC Address=IP&nbsp;|&nbsp;Диапазон&nbsp;IP&nbsp;|&nbsp;MAC
IP / MAC's non included in the list will take the Default Rate/Ceiling setting=Для IP/MAC не из списка будут применены параметры по умолчанию
IP/Range BW Limiter=Ограничение скорости IP/Диапазона
IPs currently on graphic=IP-адреса на графике
iptraf=iptraf
IP Traffic=Статистика IP
IPTraffic=Статистика&nbsp;IP
IP Traffic Daily History=Статистика IP по дням
IP Traffic Details=Статистика IP
IP Traffic Monitoring=Статистика IP
IP Traffic monitoring disabled=Статистика IP отключена в настройках
IP Traffic Monthly History=Статистика IP за месяц
IPv6 Configuration=Конфигурация IPv6
IPv6 IPSec Passthrough=Пропуск IPv6 IPSec
IPv6 Link-local Address=Адрес IPv6 Link-local
IPv6 Port Forwarding=Назначения портов IPv6
IPv6 Service Type=Тип IPv6
IPv6 support=Поддержка IPv6
IPv6 WAN Interface=Интерфейс IPv6
is=
is not allowed=не поддерживается
is not defined=не настроен
is not enabled=не подключен
is now available=доступно
is used as a root directory=используется как корневая директория
It may be also recommended to avoid using VID <b>1</b> as some vendors consider it special/reserved (for management purposes)=Так же рекомендуется избегать использования VID <b>1</b> — некоторые производители используют его для управления устройством
It may take up to 3 minutes for the upgrade to complete. Do not interrupt the router or the browser during this time=Может потребоваться до 3 минут для завершения обновления. Не прерывайте процесс и не закрывайте браузер в течение этого времени
it's performance is lower than the definitive media where files will be located=её производительность менее, чем у медиа с файлами
I would like to present you with a new project I've been working on, called TomatoAnon=Я хотел бы представить вам мой новый проект, который называется TomatoAnon
Jan=Янв
Japanese=Японский
JFFS2 is not enabled=JFFS2 не подключена
JFFS is not enabled=JFFS не подключена
Jul=Июл
Jumbo Frame Size=Размер фреймов
Jun=Июн
kbit/s=Кбит/с
KB/s=КБ/с
Keep alive=Режим выживания
Keep Alive=Постоянное
Keep Config Files=Обработать файлы конфигурации
Keep track of bandwidth usage for this IP address=Вести статистику IP для данного адреса
Key=Ключ
Key buffer=Буфер ключей
Keys=Ключи
Korean=Корейский
L2TP Server=Сервер L2TP
Labels on graphics=Значения на графиках
LAN Access=Доступ в LAN
Language=Язык интерфейса
LAN to VPN Clients=LAN к VPN клиентам
last=последний
Last 24 Hours=Последние сутки
Last 30 Days=Последние 30 дней
Last Access Time=Время последнего обращения
Last ACK=Last ACK
Last IP Address=Последний используемый IP
Last Result=Последний результат
Last Seen=Последн.&nbsp;появлен.
Last updated=Последнее обновление
LCP Echo Interval=Интервал LCP-запросов
LCP Echo Link fail limit=Кол-во LCP без ответа
Lease=Аренда&nbsp;DHCP
Leave Remote Access=Оставить упр. роутером
Leave the password field blank=Оставьте поле пароля пустым
Limit=Ограничить
Limit Connection Attempts=Ограничить попытки соединения
Limits=Ограничения
Limits per second=Ограничить соединения
Line=линия
Link=Ссылка на файл
Link With=Соединить с
Linux kernel=Ядро Linux
Listen=Listen
Listening GUI port=Порт для GUI
Listening port=Порт
List only these IPs=Показывать только эти IP
Load Balance Weight=Вес при балансировке
Load balancing=Балансировка
loading=загружается
Loading=Загрузка
Local Access=Локальный доступ
Local IP Address/Netmask=IP/Маска подсети
Local Port=Локальный порт
Local/remote endpoint addresses=Локальный/удаленный адрес
Location=Местоположение
Log FTP requests and responses=Журнал FTP
Logged Timeout=Таймаут соединения
Logging=Журнал
Logging Configuration=Настройка журнала
Log Info Level=Уровень журнала
Log Internally=Хранить на роутере
Log Level=Уровень журналирования
Logout=Выход
Logs=Журнал роутера
Log To Remote System=Удаленный компьютер
Long=Длинная
lost=потеряно
Low=Низкий
Lower=Снизу
Lowest=Низший
MAC Address=MAC-адрес
MAC addresses excluded from the portal. Leave a blank space between each MAC Address, i.e;=Список MAC-адресов, не использующих Wi-Fi Портал. Разделяйте их пробелами, например:
MAC Address List=Список MAC-адресов
MAC address whitelist=Белый список MAC-адресов
MAC Address Whitelist=Белый список MAC-адресов
MAC / IP Address=MAC / IP-адрес
make sure the directory exists and is writable=проверьте, что директория существует и доступна для записи
Manage Client-Specific Options=Настройка опций клиентов
Manual=Вручную
Manual Entry=Знач. пользователя
Mar=Мар
Master Browser=Браузер по умолчанию
Match Rule=Правило сравнения
max=максимум
Max=Max
Max allowed packet=Макс. пакет
Max Available Download=Макс. скорость загрузки
Max Available Upload=Макс. скорость отдачи
Max Bandwidth Limit=Макс. предел скорости
Max clients=Макс. клиентов
Max connections=Макс. количество соединений
Max Idle Time=Макс. время бездействия
Maximum 10 characters, no spaces=Максимум 10 символов, без пробелов
Maximum (128 bit only)=Максимальное (128 бит)
Maximum active DHCP leases=Максимальное количество DHCP-клиентов
Maximum Bandwidth for Anonymous Users=Максимальная скорость для анонимных пользователей
Maximum Bandwidth for Authenticated Users=Максимальная скорость для авторизованных пользователей
Maximum Clients=Макс. число клиентов
Maximum Connections=Максимум соединений
Maximum Connections from the same IP=Макс. количество подключений с одного IP
Maximum Hops=Макс. число переходов
Maximum Receive Unit. Max packet size the PPTP interface will be able to receive without packet fragmentation=Максимальный размер получаемого пакета PPTP-интерфейса без фрагментации
Maximum Transmission Unit. Max packet size the PPTP interface will be able to send without packet fragmentation=Максимальный размер отправляемого пакета PPTP-интерфейса без фрагментации
Maximum Users Allowed to Log in=Макс. количество авторизованных пользователей
Maximum Wait Time=Макс. время ожидания
Max Missed ARP=Макс. пропущенных ARP
Max. Perfor=макс. производительность
Max size before rotate=Макс. размер файла
May=Май
MD5SUM of WAN+LAN MAC addresses=MD5SUM из адресов WAN+LAN MAC
Measure=Измерить
Measuring Noise=Измерение помех
Measuring radio noise floor=Измерение уровня помех
Media Directories=Директории с медиа-данными
Media / DLNA Server=Медиа / DLNA сервер
Media scan may take considerable time to complete=сканирование может продолжаться длительное время
Media Server=Медиа/DLNA-сервер
Medium=Средний
Message level=Уровень детализации сообщений
Messages from this module stored internally for better trace. Level=Сообщения этого модуля хранятся локально, уровень детализации
messages per minute / 0 for unlimited=сообщений в минуту / 0 - без ограничений
meters=метров
Metric=Метрика
MHz=МГц
min=минимум
Min=Мин
Miniupnpd=Miniupnpd
Min.Perfor=мин. производительность
mins=мин.
minute=мин.
minutes=мин.
minute window=мин. график
Miscellaneous=Разное
mix=микс
Mixed Mode=Смешанный режим
Mode=Режим
Model=Модель роутера
Model of router. Ex=Модель роутера. Пример
Modem device=Устройство
Modem init string=Строка инита модема
modified by=изменено
Mon=Пн
Monday=Понедельник
Monitor=Для устройств
Monitor Web Usage=Запоминать соединения
Monthly=По месяцам
Monthly History=История за месяц
Mount=Подключить
Mount all Partitions of Storage Device=Подключить все разделы диска
mounted=смонтирован
Mounted?=Подключен?
mounted on=подключен к
Move Down=Переместить вниз
Move Up=Переместить вверх
Multicast=Мультикаст
Multicast Rate=Скорость мультикаста
Multiple LAN support integration and GUI=Поддержка нескольких LAN + GUI
Multiple/virtual SSID support (experimental)=Поддержка нескольких/виртуальных SSID
MultiWAN=Мульти-WAN
MultiWAN Routing=Маршруты M-WAN
must=должен
Must also be defined in the=Так же должен быть задан в
must be a multiple of 16=должно быть кратно 16
must be defined in the hosts area when Start With WAN is checked=должно быть указано, если отмечена настройка «Запускать вместе с WAN»
must be in different subnet to router=Подсеть должна отличаться от подсети роутера
must be supported by the upstream nameservers=должно так же поддеживаться остальными серверами DNS
must be uploaded to the device?=должен быть загружен на роутер?
must configure manually=необходимо настроить вручную
Must resolve to the external IP address where the host can be reached=Должно определяться во внешний IP-адрес, по которому можно получить доступ к хосту
Mute dhcpv4 logging=Откл. журнал для dhcpv4
Mute dhcpv6 logging=Откл. журнал для dhcpv6
Mute RA logging=Откл. журнал для RA
MutliWAN feature=Поддержка Мульти-WAN
MySQL binary path=Путь к MySQL binary
MySQL Database Server=Сервер БД MySQL
MySQL listen port=Порт MySQL
MySQL Server=Сервер MySQL
MySQL server custom config.=MySQL - конфигурация пользователя
MySQL Server custom config.=MySQL - конфигурация пользователя
MySQL Server integration and GUI=MySQL Server + GUI
Name=Имя
Name of the host. There must be an entry for this host=Имя хоста. Значение должно существовать
Name that will appear on top of your Internet Browser=Имя, отображающееся в заголовке окна баузера
Native IPv6 from ISP=ISP IPv6
NAT loopback=NAT loopback
NAT-PMP or UPnP should be enabled in least one LAN bridge. You may continue but remember to configure an access to UPnP service by Custom Configuration=NAT-PMP или UPnP должен быть включен хотя бы для одного моста LAN. Вы можете продолжить, но не забудьте настроить доступ к службе UPnP
NAT target=Тип NAT
Netbios Name=Имя Netbios
Netmask=Маска подсети
Netmask should have at least 22 bits=Маска подсети должна иметь хотя бы 22 бита
Network=Сеть
Network address assigned to this device on the local network=Сетевой адрес, связанный с этим устройством
Network Congestion Control=Network Congestion Control
Network Type=Тип сети
Never=Никогда
Never select a lower value than the kernel uses. Do not use the service test page to adjust the server performance=Не устанавливайте зачение менее импользуемого ОС. Не используйте страницу service test для регулировки/измерения производительности сервера
NEW=НОВАЯ
New Rule=Новое правило
NFS Client=NFS-клиент
NFS Server=NFS-сервер
NFS utils integration and GUI=Утилиты NFS + GUI
NGINX=Веб-сервер NGINX
NGINX Custom Configuration=Конфигурация пользователя NGINX
NGINX HTTP Section Custom Configuration=Конфигурация пользователя - раздел HTTP
NGINX is currently=NGINX в настойщий момент
Nginx & PHP=Nginx и PHP
NGINX SERVER Section Custom Configuration=Конфигурация пользователя - раздел SERVER
NGINX Web Server=Веб-сервер NGINX
No=Нет
No ACK=Без ACK
Nobody=гостя (nobody)
no cookie found=Cookies не найдено
no data=нет данных
Nodes=Nodes
No, i definitely wont enable it=Нет, не использовать
No, i don`t. Have to read all information, before i will make a choice=Нет, не знаю. Хочу прочитать об этом перед выбором
No Ingress QOS for UDP=Отключить Ingress QoS для UDP
Noise=Помехи
Noise Floor=Уровень помех
no limit=без ограничений
nolimit=без ограничений
No Limit=Без ограничений
No MAC or IP address was specified=Не указан MAC или IP
none=нет
None=Нет
N-only is not supported in wireless client modes, use Auto=Режим Только-N не поддерживается в режиме беспроводного клиента, используйте Авто
No NTLM=Без NTLM
Non-WLAN=Не-WLAN
Normal=Обычный
Normal Access Restriction=Ограничить доступ
North America=Северная Америка
not=не
Not all models support these options=Не все модели поддерживают эти параметры
not allowed=не допускается
not allowed NULL=не может быть пустым
Not Available=Не доступно
Not considered when calculating total traffic on the last line=Not considered when calculating total traffic on the last line
Note=Предупреждение
note: enable if this is a new file=примечание: включите, если это новый файл
Note: If Login Time is expired you should re-enter again into the splash page to get a new lease period. Be aware, there is no notice about expired period so, you can loss Internet Access=Замечание: если закончилось время сессии, вам нужно заново попасть на экран приверствия для получения новой сессии. Будьте внимательны, так как не существует предупреждения об окончании текущей сессии, и вы можете остаться без Интернета
Notes=Информация
note: you might wish to cross-check settings later on=заметка: возможно, стоит перепроверить настройки на
no timeout=без таймаута
Not include=Не включая
not mounted=нет подключения
not your username=не ваше имя
Nov=Ноя
Now=cейчас
NTFS Driver=Драйвер NTFS
NTLMv2=NTLMv2
NTP=Сервис NTP
NTP Time Server=Сервер времени NTP
Number of Entries to remember=Количество хранимых записей
Number of lost ARP before considering the client has leaved the connection=Число ARP-запросов без ответа, после которого клиет считается отключенным
Number of rotated logs to keep=Количество файлов журнала для хранения
Number of WAN Ports=Кол-во соединений
NVRAM Commit=Сохранить изменения в NVRAM
Oceania=Атлантика
Oct=Окт
of any physical wireless interfaces shouldn't be touched here=для любого физического интерфейса Wi-Fi не должны меняться в этом разделе
off=выкл.
Off=Выкл.
Offline=Офлайн
OK=ОК
on=на
On=Вкл.
on devices with multiple VIF capabilities=на устройствах, поддерживающих эту функцию
One and only one VID can be used for=Только один VID может быть выбран для сети
one port=один порт
One VID=Один VID
On-line from TTB=Онлайн через TTB
Online Since=Онлайн с
Only 10 ports/range sets are allowed=Поддерживается только 10 портов или диапазонов
Only at startup=Только при загрузке
Only meaningful for K24 builds=Актуально только для K24-сборок
Only one port per entry is supported when forwarding to a different internal port=Только 1 порт на правило поддерживается, если переназначается на другой номер порта в LAN
Only one untagged VLAN per port is allowed (Native VLAN)=Возможен только один нетегированный VLAN (Native VLAN) на порт
Only one VID can be selected as the default VID=Только один VID может быть выбран как VID по умолчанию
Only one VID can be used as=Только один VID может быть выбран для
Only one wireless interface can be configured in client mode=Только один Wi-Fi интерфейс может быть настроен в режиме клиента
Only required to create legacy connections with tinc1.0 nodes=Необходимо только для соединений с tinc1.0
Only these IPs=Только для IP
Open HFS/HFS+ driver=Из ядра
Open Menus=Открыть меню
Open NTFS-3G driver=NTFS-3G
Opens access to ports on machines inside the LAN, but does=Открывает доступ к компьютерам в LAN, однако
OpenVPN Client=OpenVPN-клиент
OpenVPN Client Configuration=Настройки OpenVPN-клиента
OpenVPN enhancements &amp; username/password only authentication=Дополнения OpenVPN: авторизация по логину/паролю
OpenVPN integration and GUI=OpenVPN + GUI
OpenVPN Server=OpenVPN-сервер
OpenVPN Server Configuration=Настройки OpenVPN-сервера
Openvpn username/password verify feature and configure GUI=GUI для настройки пользователей / паролей для OpenVPN
optional=не обязательно
optional; ex=не обязательно; например
Optional, space separated: domain1.com domain2.com domain3.com=Опционально, список разделённый пробелами: domain1.ru domain2.com domain3.net
option here. If incomplete dir is enabled, all incomplete files will be downloaded to=этот параметр. Если включена опция «Использ. директорию .incomplete», все файлы будут загружаться сначала в неё
option here. Whitelist is always disabled=этот параметр. Whitelist всегда отключен
option here. You can set it in Tomato GUI=этот параметр. Вы можете установить его в Tomato GUI
Options=Опции
Optware=Optware
or=или
Orange=оражевый
or Firefox for any system, or Safari. Other=или Firefox для любой платформы, или Safari. Другие
Other (Manual Configuration)=Другой (своя конфигурация)
Other Options=Другие настройки
Other relevant notes/hints=Полезные советы
Other Timeouts=Другие таймауты
oui=oui
OUI search=Поиск OUI
OUI Search=Поиск OUI
Outbound=Исходящие
Outbound Direction=Исходящие
Outbound Rates / Limits=Исх. скорость / Ограничения
Outgoing=ИСХ
out of=из
Overlapping BSS Coexistence=Разреш. пересекающ. BSS
Overview=Роутер
Packets=Пакетов
Packet Size=Размер пакета
page=странице
page, others won't be able to obtain an IP address through DHCP=, не указанные клиенты не смогут получить IP-адрес по DHCP
Paragon driver=Paragon
Partition=Раздел
passed to clientSideInclude=передан clientSideInclude
Passphrase=Пароль
Password=Пароль
Password can not be NULL value=Пароль не может быть пустым
password cannot contain=пароль не должен содержать
Password must not be empty=Пароль не может быть пустым
Path to the directory containing mysqld etc. Not include program name=Директория с mysqld и т.д. Не включая сам
Path to the directory containing transmission-daemon etc=Путь к директории с программой transmission-daemon
Peer limit per torrent=Лимит соединений на Торрент
Per Address=Per Address
Per IF=Per IF
Permit only the following clients=Разрешить только адреса из списка
PHP Custom Configuration=PHP Конфигурация пользователя
PIN Code=PIN-код
Ping=Пинг
Ping Count=Количество запросов Ping
Please be sure of your decision before change this settings=Пожалуйста, убедитесь в правильном выборе перед применением этой настройки
Please configure=Необходимо настроить
Please do not remove or change the homepage link or donate button=Пожалуйста, не меняйте адрес домашней страницы или кнопку donate
Please enter a specific address or port, or select an application match=Пожалуйста, укажите адрес или порт, либо выберите приложение  
Please enter one domain per line=Введите один домен на строку
please follow this link for instructions to get it corrected=перейдите по ссылке для получения информации по исправлению
Please Follow this Link for Instructions to get it corrected=перейдите по ссылке для получения информации по исправлению
Please go to=Пожалуйста, перейдите в
Please specify what items should be blocked=Укажите критерии блокировки 
Please start at the / root directory=Пожалуйста, запустите из / директории
Please wait=Пожалуйста, подождите
Please Wait=Пожалуйста, подождите
Please wait for=Пожалуйста, ожидайте
Please wait while the firmware is uploaded &amp; flashed=Пожалуйста, дождитесь завершения загрузки и обновления ПО
Please wait while the router restarts=Пожалуйста, дождитесь перезагрузки роутера
Please wait while the router shuts down=Пожалуйста, дождитесь отключения роутера
Policy routing traffic only work on the LAN to the Internet=правила маршрутизации применяются только к данным из локальной сети в Интернет
Poll Interval=Интервал опроса
Poptop=PoPToP
Port=Порт
Port Forwarding=Назначения портов
Port Numbers on BACK of Router Case (Left -> Right viewed from Front)=номера портов на роутере (слева направо)
Ports=Порты
Port to be used by the Captive Portal for page redirection. Port 1 to 65534. Default=Порт, используемый Wi-Fi Порталом для перенаправления. От 1 до 65534, По умолчанию
Port used for torrent client. Make sure this port is not in use=Порт, используемый для раздачи торрентов. Проверьте, что этот порт не занят другими сервисами
Port used for Transmission GUI. Make sure this port is not in use=Порт веб-интерфейса управления Transmission. Проверьте, что этот порт не занят другими сервисами
PPTP Client=PPTP-клиент
PPTP Client Configuration=Конфигурация PPTP-клиента
PPTP Gateway=Сервер PPTP
PPTP Online=PPTP-онлайн
PPTP Server=PPTP-сервер
PPTP Server Configuration=Настройки PPTP-сервера
PPTP Server integration and GUI=PPTP-сервер + GUI
PPTP User List=Список пользователей PPTP
PPTP Users Online=Список PPTP-клиентов
PPTP VPN Client integration and GUI=PPTP VPN клиент + GUI
Preamble=Преамбула
Preemption=Preemption
Prefer to show only known hostnames, otherwise show IPs=Показывать только известные имена, иначе показывать IP-адреса
Prefix Length=Длина префикса
Prevent DNS-rebind attacks=Отключить DNS-rebind
primary VIF=главного виртуального интерфейса
Prioritize ICMP=Приоритет для ICMP
Prioritize small packets with these control flags=Приоритет для малых пакетов
Priority=Приоритет
Priority Class=Класс
Private=Приватный
Private Root Directory=Частная корневая директория
Proto=Протокол
Protocol=Протокол
Provider Name=Название
Public Root Directory=Публичная корневая директория
Push=Push
Push LAN to clients=Анонсировать LAN клиентам
Qdisc Scheduler=Планировщик Qdisc
QoS=Настройки QoS
QOS Class Names=Имена классов QoS
QOS-detailed & ctrate filters=Детализация QoS & ctrate
qosdetails=настр.QoS
QoS disabled=QoS отключен
qosrates=огр.QoS
Quality=Качество
Query cache size=Кеш запросов
Queue torrents=Очередь торрентов
Quick Start-Stop Service. Enable Web Server must be checked to modify settings=Быстрый перезапуск сервиса. Веб-сервер должен быть перезапущен для изменения/применения параметров
Radio=Радиомодуль
Radio Band=Частота Wi-Fi
Radius=Radius
Radius Server=Сервер Radius
RAM Temporary=Хранить в памяти
Random=Генерировать
range=диапазон
Range=Диапазон
range of ports=диапазон
Rate=Rate
Rates=Rates
Read buffer size=Буфер чтения
Read only=Только чтение
Read Only=Только чтение
Read rand buffer size=Буфер чтения rand
Read / Write=Чтение/Запись
Read/Write=Чтение/Запись
Real-Time=В реальном времени
Realtime bandwidth monitoring of LAN clients=Загрузка сети в реальном времени
Real-Time Client Monitor=Подключенные клиенты
Reboot=Перезагрузка
Reboot?=Перезагрузить?
Rebooting=Перезагрузка
reboot required to turn off LEDs=для отключения индкаторов требуется перезагрузка роутера
Receive Antenna=Приёмная антенна
received=получено
Recently Visited Web Sites=Посещенные сайты
Recent Web Searches=Поисковые запросы
recommended=рекомендуется
Reconnect=Переподключение WAN
recreated=пересозданы
recreated=создан заново
Red=красный
Redial Interval=Интервал повтора
Redirect all users from=Перенаправить всех польз. из
redirect Internet traffic=перенаправлять трафик Интернета
Redirect Internet traffic=Установить как шлюз по умолчанию
redirections=назначений
Redirect remote access ports for SSH and HTTP(s) to router=Переназначить порты SSH и HTTP(s) на роутер
Redirect TCP Ports=Обрабатывать TCP порты
Redirect through VPN=Отправить через VPN
Reduce packet size=Уменьшить размер запроса
re-enter to confirm=Повторите ввод
Refresh=Обновить
Refresh Status=Обновить состояние
Regenerate=Пересоздать
Regulatory Mode=Регулирующий стандарт
Re-init priv. table=Пересоздать таблицы привилегий
Re-init root password=Пересоздать мастер-пароль (root)
Relay Anycast Address=Relay Anycast Address
Release=Освободить
Remaining Lease Time=Обновление IP через
re-map ports=переназначает порты
Remote access=Удаленый доступ
Remote Access=Удаленный доступ
Remote Forwarding=Разрешить перенаправления
Remote IP addresses to be used on the tunnelled PPP links (max 6)=Эти IP-адреса будут использоваться для PPP-соединений (не более 6)
Remote IP Address Range=Диапазон IP для клиентов
Remote Port=Удаленный порт
Remote subnet / netmask=Удаленная сеть / маска
removed=удалено
Renew=Обновить
Request /64 subnet for=Запросить подсеть /64 для
request per second=запросов в сек.
Required (128 or 40 bit)=Обязательно (128 или 40 бит)
Rescan on the next run=Пересканировать при следующ. запуске
Reset class when changing settings=Сбросить классы при изменении параметров
Reset Data=сброс текущих данных
resolve=определить
Resolver=Преобразователь
Resolver Details=Информация
Resolve the hostname of this address=Определить имя для этого адреса
Respond to DNS=Отвечать на DNS-запросы
Respond to ICMP ping=Отвечать на ping из WAN
Restart=Перезапустить
Restarting=Перезагрузка
Restore=Восстановить
Restore Configuration=Восстановить настройки
Restore data from=Восстановить данные из
Restore Default Configuration=Восстановить конфигурацию по умолчанию
Restore default router settings (normal)=Восстановить настройки роутера по умолчанию (обычный режим)
Restoring Defaults=Восстановление настроек по умолчанию
Restriction=Ограничение
Results from=вывод команды
reverse=инверт. цвета
Revised IP/MAC Bandwidth Limiter=Новый ограничитель скорости по IP / MAC
RO Community=RO Community
Root=супер-пользователя (root)
Root Directory=Корневая директория
root password=Пароль супер-пользователя
root user name=Имя супер-пользователя (root)
Round-Trip=Round-Trip
Route Modem IP=Маршрут к IP модема
Router=Роутер
Router Identification=Идентфикация роутера
Router IP Addresses=IP-адрес роутера
Router IPv6 Address=IPv6-адрес роутера
Router MAC Address=MAC-адрес роутера
router may be harmful. It may not be able to re-setup the NVRAM correctly after a complete erase. Proceeed anyway?=роутера может быть небезопасной. Он может не восстановить все необходмые значения после полной очистки. Продолжить?
Router must be rebooted to proceed. Commit changes to NVRAM and reboot now?=Роутеру требуется перезагрузка. Сохранить изменения в NVRAM и перезагрузить устройство?
Router Name=Имя роутера
Router's LAN MAC Address=MAC-адрес LAN роутера
Router Time=Дата и время роутера
Routes must be configured manually=Маршруты должны быть настроены отдельно
Routing=Маршрутизация
Routing Policy=Правила маршрутизации
Routing Table=Таблица маршрутизации
RSA Private Key=Приватный ключ RSA
RSA Public Key=Публичный ключ RSA
RSSI=RSSI
RTS Threshold=Порог RTS
Rule=Правило
Rules=Правила
Run after mounting=Скрипт после подключения
Run As=Запускать от имени
Run before unmounting=Скрипт перед отключением
Run Custom Script=Запустить скрипт
running=работает
Russian=Русский
RX=RX
RX Bytes=Получено,&nbsp;Байт
Safely Remove Storage Device=Безопасное отключение диска
Samba File Sharing=Сервис Samba
Same as normal lease time=Совпадает со стандартным
same as used in QoS=параметры из настроек QoS
Sat=Сб
Saturday=Суббота
Save=Сохранить
Saved=Сохранено
Save Frequency=Частота сохранения
Save History Location=Местоположение истории
Save In NVRAM=Сохранить изменения в NVRAM
Save On Shutdown=Сохранять при выключении 
Save settings location=Путь для сохранения параметров
Save state when IP changes=Сохранять состояние при изменении IP
Saving=Сохранение
Scale=Единицы
Scan=Сканировать
Scan Media at Startup=Сканировать при загрузке
scanning=сканирование
Schedule=Задание
Scheduler=Планировщик
Script is fully open, and written in bash. Anyone is free to look at the content that is submitted to the database=Скрипт написан на языке bash. Вы можете посмотреть в нем, что именно отправляется в БД
Script is fully open, and written in bash. Anyone is free to look at the content that is submitted to the database=Код скрипта открыт и написан на bash. Каждый может проверить его содержимое и что отправляется в БД
script is too long. Maximum allowed is=Скрипт слишком большой. Максимальный размер
Scripts=Скрипты
SDHC / MMC=SDHC / MMC
SD-idle tool integration for kernel 2.6=SD-idle для ядра 2.6
SD/MMC Card Support=Поддержка SD/MMC
Search Criteria=Критерий поиска
Searches=Поисковые запросы
Search Time=Время поиска
second=сек.
second interval=сек. интервал
seconds=сек.
Seconds=сек.
seconds per hop=сек. на переход
Secret=Скрыт
Secure Mode=Безопасный режим
Security=Безопасность
see=смотрите
See also the=Смотрите так же
Seeds queuing=Очередь сидования
Select=Выбрать
Select Cancel=Выберите «Отмена»
Selected IP`s=Заданные IP-адреса
Selected Ports=Заданные порты
Select one of the bridges on which Captive Portal will listen=Выберите один из мостов, в котором будет размещен Wi-Fi Портал
Select the configuration file to restore=Выберите файл для восстановления
Select the file to use=Выберите файл
Select user used to start nginx and php-cgi daemon=Выберите пользователя для запуска служб nginx и php-cgi
Self-explanatory=Название говорит само за себя
Sep=Сен
Seq=Номер
Serial No=Серийный номер
Server=Сервер
Server Address=Адрес сервера
Server Address/Port=Адрес сервера/порт
Server Certificate=Сертификат сервера
Server is not running or status could not be read=Сервер не запущен, или статус не может быть определен
Server is on the same subnet=Сервер находтся в той же подсети
Server Key=Ключ сервера
Server Priority=Приоритет
Server Root Path=Корневая директория
SERVER Section=Раздел SERVER
Service=Сервис
Service Name=Имя службы
SES/WPS/AOSS Button=Кнопка SES/WPS/AOSS
set=установлены
Sets the service priority over other processes running on the router=Устанавливает приоритет сервиса относительно остальных запущенных служб
Sets the service priority over other processes running on the router=Приоритет процесса отосительно остальных запущенных
setting=на роутере.
Settings=Настройки
Settings for DSL only=Настройки для DSL
settings page for more DHCP-related configuration options=для установки дополнительных опций DHCP
set to 0 to disable=укажите «0» для отключения
set to '0' to use 'regular' VLAN/VID mappings instead=установите <b>0</b> для использования стандартного VLAN/VID соотвествия
Severe=Низкий
Shared Key=Общий ключ
Share Name=Имя
Short=Короткая
show=показать
Show=Показать
Show hostnames=Показать имена хостов
showing=показано
Show In My Network Places=Показывать как UPnP-устройство в Microsoft Windows
Show known hostnames=Показывать имена
Show known hostnames and IPs=Показывать известные имена и IP-адреса
Show only IPs=Показывать только IP-адреса
Show only these IPs=Показать только эти IP
Show shortcuts=Показать ярлыки
Show Speed Info=Информация о скорости
Show subnet totals=Общее для подсетей
Show up to=Показывать не более
Shutdown=Выключение
Shutdown?=Выключить?
Shutting down=Выключение
Signal Quality=Качество сигнала
Silent=Silent
Simplified Chinese=Китайский (упрощ.)
Single Line MLPPP=Использовать MLPPP
SNMP=SNMP
SNMP integration and GUI=SNMP + GUI
SNMP Settings=Настройки SNMP
Socks Port=Порт Socks
Solid=площадь
some of the changes will take effect after a restart=некоторые изменения будут применены только после перезагрузки
Some of the changes will take effect only after a restart=Некоторые изменения будут применены только после перезагрузки
Sorry, your browser does not support=К сожалению, ваш браузер не поддерживает
Sorry, your browser does not support=Ваш браузер не поддерживает
Sort buffer size=Буфер сортировки
so that previously defined/saved settings might need to be updated/changed accordingly on=Вам может потребоваться обновление/изменение настроек в разделе
Source=Источник
Source Address=Адрес источника
Source address allowed. Ex=Разрешенные адреса. Пример
Source and Destination interfaces must be different=Интерфейсы источника и назначения должны различаться
Source IP Address=IP-адрес источника
Source LAN bridge=Исходный мост LAN
South America=Южная Америка
space=пробел
space separated=разделено пробелами
Special Thanks=Отдельное спасибо
Spin down each HDD when idle. No need to use with flashdrive=Останавливать мотор HDD при неиспользовании. Не требуется для флеш-дисков
S Port=SRC-порт
Src=SRC
Src Address=SRC-адрес
Src IP=SRC IP
Src MAC=SRC MAC
Src or Dst=SRC или DST
src port=src-порт
Src Port=SRC-порт
SSH Daemon=Сервис SSH
SSID=Имя сети (SSID)
SSL Certificate=SSL сертификат
Start=Запустить
start cmd.exe and type chcp to see the current code page=запустите cmd.exe и выполните chcp для просмотра вашей кодировки
Startup LED=Startup LED
Start with WAN=Запускать вместе с WAN
Start With WAN=Запускать вместе с WAN
Stateless MPPE connection=Опциональное шифрование соединения
Static=Постоянный
Static ARP binding=Постоянная ARP-таблица
Static DHCP/ARP=Постоянный DHCP/ARP
Static DHCP/ARP/IPT=Назначения DHCP/ARP/IPT
Static DNS=Постоянный DNS
Static IP=Постоянный IP
Static Key=Постоянный ключ
Static Lease=Постоянное назначение
Static lease time=Срок аренды постоянных адресов
Static Routing Table=Статическая таблица маршрутов
Status=Состояние
Status Button=Кнопка состояния
Stealth Mode=Ночной режим
Stop=Остановить
stopped=не запущен
Stop seeding at ratio=Остановить сидирование при ratio
Stop seeding if idle for=Остановить сидирование через
Strictly adhere to DLNA standards=Строгий DLNA стандарт
Strict-Order=В порядке следования
Subnet=Подсеть
subnet-down=subnet-down
Subnet is left blank when using the TAP Interface Type=Это поле не заполняется при типе соединения TAP
Subnet Mask=Маска подсети
subnets=подсети
Subnets=Подсети
subnet-up=subnet-up
Subtree Check=Subtree Check
Summary=Состояние
Sun=Вс
Sunday=Воскресенье
Sync=Sync
SYN Received=SYN Received
SYN Sent=SYN Sent
Syslog=Сервис Syslog
System=Система
System Commands=Команды системы
table.=как активный.
Table open cache=Кеш таблиц
Tagged=С тегом
Target=Цель
TCP Limit=Огранич.&nbsp;TCP
TCP Timeout=Таймауты TCP
TCP/UDP=TCP/UDP
TCP Vegas=TCP Vegas
Telnet Daemon=Сервис Telnet
Temperature=Температура
Temporary=временно
Thanks=Спасибо
Thanks to everyone who risked their routers, tested, reported bugs, made suggestions and contributed to this project=Спасибо всем, кто рисковал своими устройствами, тестировал, сообщал об ошибках, вносил предложения и учавствовал в проекте 
Thank you for reading and please make the right choice to help this project=Спасибо за внимание и, пожалуйста, сделайте правильный выбор и поддержите проект
That`s it=В целом, всё
the address of the network cannot be used=Адрес сети не может быть использован
The bandwidth will be shared by all hosts in br1=Полоса будет разделена между всеми клиентами моста br1
The bandwidth will be shared by all hosts in br2=Полоса будет разделена между всеми клиентами моста br2
The bandwidth will be shared by all hosts in br3=Полоса будет разделена между всеми клиентами моста br3
The bandwidth will be shared by all unlisted hosts in br0=Полоса будет разделена между всеми не указанными выше клиентами моста br0
the broadcast address cannot be used=Адрес броадкаста не может быть использован
The contents of file /etc/dnsmasq.custom are also added to the end of Dnsmasq's configuration file (if it exists)=Содержимое файла /etc/dnsmasq.custom будет добавлено к опциям Dnsmasq (при наличии файла)
The cstats program is not responding or is busy. Try reloading after a few seconds=Программа cstats не отвечает, попробуйте обновить страницу позже
The default settings are indicated with an asterisk=Значения по умолчанию отмечены звездочкой
The destination address inside the LAN=IP-адрес компьютера назначения в LAN
The destination port inside the LAN. If blank, the destination port is the same as=Порт назначения в LAN. Если не указан, то совпадает с
The device is busy. Please make sure no applications are using it, and try again.=Диск занят! Проверьте, что он не используется приложениями, и попробуйте снова.
The Following=Из списка
The following data is sent by TomatoAnon=Следущие данные отправляются скриптом TomatoAnon
the following day=в выбранные дни
The following NTP servers have been automatically blocked by request from the server=Эти серверы времени были отключены по запросу
The information submitted is 100% anonymous and will ONLY be used for statistical purposes=Отправляемые данные полностью обезличены и предназначены только для статистики
The IP Range devices will share the Bandwidth=IP из указанного диапазона будут разделять скорость между собой
The level of compression used for UDP packets. Possible values are=Степень сжатия для UDP-пакетов. Возможные значения
The local http/https must also be enabled when using remote access=Локальный http/https сервер так же должен быть включен для удаленного доступа. Включить http/https?
The location where the Welcome banner is located=Расположение баннера подключения
Theme name from=Имя темы из
The name of the Gateway appearing in the welcome banner=Название Портала в баннере подключения
The netmask for the entire VPN network=Маска сети VPN
The NVRAM Dump text file may contain information like wireless encryption keys and usernames/passwords for the router, ISP and DDNS. Please review &amp; edit this file before sharing it with anyone=Дамп NVRAM является текстовым файлом и может содержать данные паролей для ISP, DDNS и другую конфиденциальную информацию. Пожалуйста, изучите его содержимое перед предоставлением доступа к нему другим
The NVRAM free space is very low. It is strongly recommended to=NVRAM почти заполнен. Рекомендуется
The operating system kernel has priority=Приоритет операционной системы
The path in your router where documents are stored=Путь к директории на роутере, где хранятся веб-документы
The ports to be forwarded, as seen from the WAN. Ex=Порты для перенаправления, со стороны WAN. Пример
The ports to be opened for forwarding. Ex=Порты, которые будут перенаправлены (доступны из WAN). Пример
The port the host listens on. If empty the default value (655) is used=Порт службы. Пустое поле - значение по умолчанию (655)
The Port used by the Web Server to be accessed. Check conflict when the port is used by other services=Порт, по которому будет доступен веб-сервер. Проверьте, что этот порт не используется другими службами
There is no upload status information in this page and there will be no change in the display after the Upgrade button is pushed. You will be shown a new page only after the upgrade completes=Эта страница не отображает прогресс загрузки и не меняется после нажатия кнопки «Обновить». Вы увидите новую страницу только после завершения обновления прошивки.
The router's new IP address is=Новый IP-адрес роутера
The router will reset its address back to 192.168.1.1. You may need to renew your computer's DHCP or reboot your computer before continuing=Роутер вернет собственный IP-адрес 192.168.1.1. Вам может потребоваться перезагрузить ваш компьютер или заново запросить IP-адрес по DHCP для продолжения работы
The rstats program is not responding or is busy. Try reloading after a few seconds=Программа rstats не отвечает, попробуйте обновить страницу позже
These ports are automatically closed after a few minutes of inactivity=Эти порты будут автоматически очищены спустя некоторое время отсутствия активности на них
The submitted results can be viewed on the=Отправленные данные можно посмотреть на 
The subnet which the host will serve=Подсеть, которую обслуживает хост
the tag contains only user priority information=тег содержит только информацию о приоритете
The TomatoAnon script will send (to a database) information about your router's model and installed version of Tomato=Скрипт TomatoAnon отправит (в базу данных) информацию о модели роутера и установленной версии Томато
The URL that will appear after you Agree the Welcome Banner=URL домашней страницы (открывается по нажатию «Agree»)
This feature is not supported on this router=Эта функция не поддерживается роутером
This information may help you when choosing the best and most popular router available in your country=Эта информация может быть полезной при выборе роутера, наиболее популярного в вашей стране
This option will open the Transmission GUI port from the WAN side and allow the GUI to be accessed from the internet=При включении этой опции веб-интерфейс управления будет доступен из Интернета
This option will open the Web Server GUI port from the WAN side. Service will be accessed from the internet=Включение этой опции сделает GUI веб-сервера доступным из Интернета
This rule is too big. Please reduce by=Слишком большое правило. Уменьшите до
This script does NOT send any private or personal information whatsoever (like MAC`s, IP`s etc)=Этот скрипт не отправляет какой-либо частной или персональной информации (как MAC, IP-адрес и т.д.)
This service determines the IP address using its own method=Этот сервис определяет IP-адрес собственным способом.
This web interface allows configuring a maximum of 4 VIFs for each physical wireless interface available=Вы можете настроить до 4-х виртуальных интерфейсов для каждого физического интерфейса Wi-Fi
this will identify a router. Ex=это идентифицирует ваш роутер. Пример
Thread cache size=Кеш потоков
Thread stack=Стек потоков
Thu=Чт
Thursday=Четверг
Time=Дата и время
Time Wait=Time Wait
Time Zone=Часовой пояс
Tinc Configuration=Настройки Tinc
Tinc Daemon=Сервис Tinc
Tinc Daemon integration and GUI=Tinc + GUI
tinc-down=tinc-down
Tinc is currently=Tinc в наст. момент
Tinc Mesh VPN=VPN Tinc
tinc-up=tinc-up
tinc-up creation=tinc-up creation
Tinc will try to establish a meta-connection to the host. Requires the Address field=Tinc попытается установить meta-соединение. Необходимо поле Адрес
TiVo Support=Поддержка TiVo
TKIP encryption is not supported with WPA / WPA2 in N and AC mode=Шифрование TKIP не поддерживается при WPA / WPA2 в N и AC режимах
TKIP encryption is not supported with WPA / WPA2 in N mode=Шифрование TKIP не поддерживается при WPA / WPA2 в N режиме
TLS Renegotiation Time=Время пересогласования TLS
Tmp dir.=Временная директория
to=к
To=К
To activate the PHP support (php-cgi) tick and save this screen=Для включения PHP отметьте этот параметр и сохраните изменения
To activate the Web Server tick and save this screen=Для включения WEB-сервера отметьте этот параметр и сохраните изменения
To clear the credentials cached by the browser=Для очистки данных авторизации в браузере
To Destination IP=К DST IP
to disable=для отключения
To Domain=К домену
To enable/enforce static ARP binding for a particular device, it must have only one MAC associated with that particular IP address (i.e. you can't have two MAC addresses linked to the same hostname/device in the table above)=Для постоянной привязки ARP, устройство должно иметь только один MAC ассоциированным с IP-адресом (то есть вы не можете иметь для этого устройства несколько MAC привязанных к имени хоста в таблице выше)
Toggle Visibility=Переключить видимость
Toggle Wireless=Переключение Wi-Fi
Token / URL=Токен / URL
TomatoAnon=TomatoAnon
TomatoAnon configuration page=настройки TomatoAnon
TomatoAnon Project=Проект TomatoAnon
TomatoAnon project integration and GUI=TomatoAnon + GUI
TomatoAnon Settings=Настройки TomatoAnon
Tomato-ARM Team=Команда Tomato-ARM
TomatoThemeBase project integration and GUI=TomatoThemeBase + GUI
Tomato Update Notification System=Система уведомлений об обновлении Tomato
TomatoUSB Team=Команда TomatoUSB
Tools=Сетевые утилиты
Tools - System refresh timer=Tools - System refresh timer
Too many addresses=Слишком много адресов
Too many hostnames=Слишком много имен хостов
Too many IP addresses=Слишком много IP-адресов
To prevent 802.1Q compatibility issues, avoid using VID <b>0</b> as 802.1Q specifies that frames with a tag of <b>0</b> do not belong to any VLAN=Во избежание проблем с 802.1Q, не используйте VID <b>0</b> — 802.1Q определяет фреймы с тегом <b>0</b> как не принадлежащие ни к одному VLAN
TOR Project=Проект TOR
TOR Project integration and GUI=TOR Project + GUI
To specify multiple hostnames for a device, separate them with spaces=Для задания нескольких имен, разделяйте их пробелами
total=всего
Total=Всего
Total / Free Memory=Всего / Свободно RAM
Total / Free NVRAM=Всего / Свободно NVRAM
Total / Free Size=Всего / Свободно
Total / Free Swap=Всего / Свободно SWAP
Trace=Трассировка
Traceroute=Трассировка
Tracking / NAT Helpers=Транзит соединений / помощники NAT
Traditional Chinese / Big=Китайский (трад.)
Transfer Rates=Скорость QoS
Transferred=Передано
Transmission 2.92 integration=Transmission 2.92
Transmission binary path=Расположение Transmission
Transmission Rate=CT Rate
Transmit Antenna=Передающая антенна
Transmit Power=Мощность передатчика
transmitted=передано
Trans Port=Порт транспорта
Trigger Connect On Demand=Обновлять при подключении
Triggered=Триггеры
Triggered Port Forwarding=Переключаемые порты
Trigger Ports=Порты-триггеры
Trigger Ports are the initial LAN to WAN 'trigger'=Порты-триггеры являются причиной открытия портов при обращении с них из LAN в WAN
Try to avoid any conflicts and/or overlaps between the address ranges configured/available for DHCP and VPN clients on your local networks=Старайтесь избегать пересечения адресов и диапазонов IP для DHCP и VPN клиентов в вашей локальной сети
TTB ID=TTB ID
TTL Adjust=Изменение TTL
Tue=Вт
Tuesday=Вторник
Tunnel address/netmask=Адрес туннеля/маска подсети
Tunnel Client IPv6 Address=IPv6-адрес клиента туннеля
Tunnel MTU=Значение MTU для туннеля
Tunnel Remote Endpoint (IPv4 Address)=Tunnel Remote Endpoint (IPv4 Address)
Tunnel TTL=Значение TTL
Turns on broadcast relay between VPN clients and LAN interface=Включить поддержку броадкаста для VPN-клиентов
Tutorial and discussion=Учебник и обсуждение
Tuxera driver=Tuxera
TX=TX
TX/RX Rate=TX/RX
Type=Тип
UDP limit=Огранич.&nbsp;UDP
UDP Limit=Огранич.&nbsp;UDP
UDP Timeout=Таймауты UDP
UDPxy integration and GUI=UDPxy + GUI
Udpxy port=Порт Udpxy
ULCeil=UL&nbsp;Ceil
ULCeil must be greater than ULRate=UL Ceil должен быть больше чем UL Rate
ULCeil must between 1 and 99999=UL Ceil должен быть между 1 и 99999
UL Rate=UL-Rate
ULRate=UL&nbsp;Rate
ULRate must between 1 and 99999=UL Rate должен быть между 1 и 99999
Unclassified=Нет класса
Uniform=Uniform
Unique identifier associated to a network interface on this particular device=Уникальный идентификатор, ассоциированный с сетевым интерфейсом на этом устройстве
Unique identifier of a VLAN=Уникальный идентификатор VLAN
United States, Canada=США, Канада
Unknown Port Mapping Using Default=Неизвестное устройство
unlimited=без ограничений
Unmount=Отключить
Unmount all USB Drives=Отключить все USB-диски
Unplugged=Отключен
Unplugged=Не подкл.
Unreplied=Unreplied
Unsaved changes will be lost. Continue anyway?=Несохраненные изменения будут утеряны. Продолжить?
unset=удалить
Unspecified=Не задано
until network is restarted and this page is reloaded=пока не перезагрузится сеть и эта страница
Up=Вкл.
Upgrade=Обновление
Upgrade Firmware=Обновление прошивки
Upload=Отправить
Upload ceil=UL&nbsp;Ceil
Uploaded=Отправлено
Upload file size limit=Максимальный размер файлов для загрузки
Upload limit=Ограничение скорости отдачи
Upload rate=UL&nbsp;Rate
Upload slots per torrent=Лимит слотов на Торрент
UPnP / NAT-PMP=UPnP / NAT-PMP
Upper=Сверху
UPS Monitor=Монитор UPS
Uptime=Время работы
Uptime of your router. Ex: 3 days=Время от включения. Пример: 3 дня
up to 3 extra VIFs can be defined in addition to the primary VIF=до 3-х дополнительных виртуальных интерфейсов может быть добавлено к основному
URL Excluded off Captive Portal=Исключенные URL
URL excluded off the portal=Исключенные из портала URL
URLs that can be accessed without the Welcome banner screen appearing. When you set allowed url's also leave a blank space between each url. i.e;=Эти URL будут открываться без баннера. Оставляйте пробелы между каждым URL из этого списка. Пример:
US=США
USB 1.1 Support=USB 1.1
USB 2.0 Support=USB 2.0
USB 3.0 Support=USB 3.0
USB 3G Modem support=Поддержка USB 3G-модемов
USB and NAS=USB и NAS
USB Audio Support=Поддержка USB-аудио
USB Printer Support=USB принтер
USB Storage Support=Поддержка дисков
USB Support=Поддержка USB
USB support integration and GUI=Поддержка USB + GUI
Use=Использовать
Use alternate NAS startup=Использовать альтеранитвный запуск NAS
Use alternate NAS startup sequence=Использовать другой запуск NAS
Use as DNS=Использовать DNS
use default=по умолчанию
Use Default=Параметры по умолчанию
Use DHCP=Использовать DHCP
Use dnscrypt-proxy=Использовать dnscrypt-proxy
Use External IP Address Checker (every 10 minutes)=Использовать внешний скрипт проверки IP (каждые 10 минут)
Use internal DNS=Локальный DNS
Use @IP for the current IP address=Use @IP for the current IP address
Use Ping only when Traceroute is not working correctly=Используйте Пинг только если Трассировка не работает должным образом
Use prefereable one of the two option to avoid conflicts=Используйте одну из двух опций для избежания конфликтов
User Accounts=Список пользователей
User config file path=Путь к файлу конфигурации
User config file will be used, some of GUI settings will be ignored=При использовании файла конфигурации пользователя некоторые из настроек в GUI будут проигнорированы
Use received DNS with user-entered DNS=Использовать принятые и определенные пользователем DNS
User Guide=Руководство по настройке
User ID=ID пользователя
Username=Имя пользователя
User Name=Имя пользователя
Username and password can not be empty=Имя пользователя и пароль не могут быть пустыми 
Username Authen. Only=Только авторизация Пользователь/Пароль
user name cannot contain=имя пользователя не должно содержать
user name connected to server=имя пользователя для подключения к серверу
Username / Hostname=Пользователь / Имя хоста
username is mandatory=имя пользователя обязательно
Username/Password Authentication=Пользователь/Пароль
User names=Имена пользоват.
use the=используйте
Use '-' to specify a range of ports=Используйте символ «-» для задания диапазона портов
Use user config file=Файл конфигурации пользователя
Use user-entered gateway if WAN is disabled=Использовать шлюз пользователя, если WAN отключен
Use WAN2 IP Address=Использовать IP-адрес WAN2
Use WAN3 IP Address=Использовать IP-адрес WAN3
Use WAN4 IP Address=Использовать IP-адрес WAN4
Use WAN IP Address=Использовать IP-адрес WAN
Using QoS=Использование QoS
usually=обычно
Valid range=Разрешенный диапазон
Value=Значение
Value cannot contain=Значение не должно содержать
Value is mandatory=Обязательное поле не заполнено
Verbose=Verbose
Verify server certificate=Проверка сертификата сервера
version=версия
Version=Версия
Video only=Видео
VID Offset=Смещение VID
View All=Показать все
View Details=Статистика
View Graphs=Диаграммы
View IP Traffic History=Посмотреть статистику IP
View Last 100 Lines=Последние 100 строк
View Last 25 Lines=Последние 25 строк
View Last 50 Lines=Последние 50 строк
View Only=Только просмотр
View Per-Connection Transfer Rates=Просмотреть ограничения для каждого соединения
View QoS Details=Показать правила QoS
View real-time IP Traffic for this address=Статистика IP этого адреса
View transfer rates per connection=Посмотреть скорость передачи для каждого соединения
Virtual Interfaces=Виртульные интерфейсы
Virtual Wireless=Virtual Wi-Fi
Virtual Wireless Interfaces=Виртульные интерфейсы Wi-Fi
VLAN administration GUI=Управление VLAN + GUI
VLAN ID assigned to untagged frames received by the router=VLAN ID, который будет присвоен полученным роутером нетегированным фреймам
VPN Clients to LAN=Клиенты VPN к LAN
VPN IP Address=VPN IP-адрес
VPN Netmask=Маска сети VPN
VPN subnet/netmask=VPN подсеть/маска
VPN Tunneling=Сервисы VPN
Wake On LAN=Пробуждение по сети
Wake Up=Разбудить
WAN Bandwidth - Daily=Загрузка WAN - по дням
WAN Bandwidth - Monthly=Загрузка WAN - по месяцам
WAN Bandwidth - Weekly=Загрузка WAN - по неделям
WAN Port Speed=Скорость порта WAN
WAN Up=Подкл. WAN
Warning=Предупреждение
WARNING=ПРЕДУПРЕЖДЕНИЕ
Warning: 10 second timeout, restarting=Предупреждение: 10 секунд нет данных, перезапуск
Warning: Cannot bridge distinct subnets. Defaulting to routed mode=Предупреждение: не возможно объединить разные подсети в мост. Переключение в режим маршрутизации
Warning: Changing the MAC address may require that you reboot all devices, computers or modem connected to this router. Continue anyway?=Предупреждение: при изменении MAC-адреса может потребоваться перезагрузка и переподключение всех устройств, подключенных к данному роутеру. Продолжить?
WARNING: Erasing the NVRAM on a=ВНИМАНИЕ: очистка NVRAM на
Warning: Must define Certificate Authority=Предупреждение: необходимо указать Центр Сертификации
Warning: Web Admin is about to be disabled. If you decide to re-enable Web Admin at a later time, it must be done manually via Telnet, SSH or by performing a hardware reset. Are you sure you want to do this?=Доступ для администрирования через Веб будет отключен. Если вы захотите включить его обратно, воспользуйтесь Telnet, SSH, или сбросьте настройки кнопкой «Ресет». Вы уверены, что хотите продолжить?
Warning: Wireless connections to this router may be disrupted while using this tool=Предупреждение: беспроводные соединения могут быть прерваны в процессе работы данного приложения
warning: WL driver reports BSSID=предупреждение: WL-драйвер сообщает BSSID
Watchdog Mode=Способ проверки
WDS MAC address required=Необходимо указать MAC-адрес для WDS
Web Admin=Администратор Web
Webmon Backup Script=Скрипт бэкапа Webmon
Web Monitor=Монитор соединений с Интернетом
Web Monitor Configuration=Настройка использования Интернета
Web Monitoring disabled=Монитор использования Интернета отключен
Web Server=Web-сервер
Web Server Menu=Меню Web-сервера
Web Server Name=Имя Web-сервера
Web Server Port=Порт Web-сервера
Web Usage=Посещённые сайты
Wed=Ср
Wednesday=Среда
Weekly=По неделям
Week Start=Начало недели
Welcome html Path=Путь к HTML
Western Europe=Западная Европа
We want to express our gratitude to all people not mentioned here but contributed with patches, new models additions, bug solving and updates to Tomato firmware=Мы хотели бы выразить нашу благодарность всем, а не только упомянутым здесь, кто сообщал об ошибках, присылал патчи исправлений и добавлений для поддержки новых моделей роутеров
wfilter=wfilter
When active, the 'Home Page' (read next line) will appear after you Agree in Welcome Banner=Если включено, после нажатия «Agree» будет показана домашняя страница (см. следующий параметр)
When ARP binding is enabled for a particular MAC/IP address pair, that device will always be shown as 'active' in the=Когда задана привязка ARP для конкретного MAC/IP, он всегда будет отображаться на странице
When creating/defining a new wireless VIF, it's MAC address will be shown (incorrectly) as '00:00:00:00:00:00', as it's unknown at that moment=При создании нового виртуального Wi-Fi интерфейса, его MAC-адрес будет отображаться (не корректно) как «00:00:00:00:00:00», поскольку в настоящий момент он не известен
when enabled, UPnP clients are allowed to add mappings only to their IP=если включено, UPnP клиенты могут добавлять правила только с собственным IP
When new tomato version will be available, you will be notified about this on=При выходе новой версии прошивки, вы будете уведомлены об этом на странице
When no directory is specified=Когда не указана директория
When no Root Directory is specified for the user, the default 'Public Root Directory' is used=Если не определено, используется общая корневая директория
When no shares are specified and auto-sharing is disabled=Если нет настроенных директорий и авто-доступ отключен
When Pushed For=Если нажата в течение
When saving changes, the MAC addresses of all defined non-primary wireless VIFs could sometimes be (already)=При сохранении изменений, MAC-адреса всех дополнительных виртуальных интерфейсов Wi-Fi могут быть (уже)
When setting any port (included or excluded) leave a blank space between each port number, i.e;=При установке портов (как исключенных, так и добавленных), используйте пробелы. Пример:
when the network conditions poor, try use long detection period=при нестабильном соединении попробуйте увеличить интервал
When you tick and save the router will show a Welcome Banner when a computer access the Internet=При выборе этой настройки, на компьютере пользователя будет отображаться баннер при подключении к Интернету
Which ethernet ports on the router should be members of this VLAN=Какой из портов роутера должен содержать данный VLAN
Which LAN bridge this VIF should be assigned=К какому мосту LAN должен быть подключен этот виртуальный интерфейс
White=Белый
Whitelist=Белый список
Whitelisted domains=Имена в белом списке
Wildcard=Wildcard
will be treated as a file. If this is a directory, please use a trailing /. Continue anyway?=указана как файл. Если это директория, пожалуйста, добавьте слеш (/) в конце. Продолжить? 
WINS=Сервер WINS
WINS Server=Сервер имен WINS
WINS Servers=Серверы WINS
Wireless=Wi-Fi
Wireless access has been temporarily disabled for=Беспроводной доступ был временно отключен для:
Wireless Client=Беспроводной клиент
Wireless Client Filter=Фильтр беспроводных клиентов
Wireless Client Mode=Беспроводной клиент
Wireless Ethernet Bridge=Беспроводной мост
Wireless Filter=Список фильтрации Wi-Fi
Wireless Interface=MAC-адрес Wi-Fi
Wireless Interfaces Details=Информация об интерфейсах Wi-Fi
Wireless Mode=Тип
Wireless Multicast Forwarding=Оптимизация мультикаста (WMF)
Wireless Network Mode=Режим Wi-Fi
Wireless Service Set Identifier=Идентификатор беспроводного сервиса
Wireless Settings=Настройки беспроводной сети
Wireless Site Survey=Обзор беспроводных сетей
Wireless Survey=Обзор Wi-Fi сетей
Wireless Temperature=Температура Wi-Fi
Wireless VIF name=Имя беспроводного интерфейса
with this id in your page=c этим ID на странице
WLAN Auto with Noise Reduction=WLAN Auto c шумоподавлением
WOL=WOL
Word Wrap=Перенос строк
Workgroup Name=Рабочая группа
works only with non-Hilink modems=не применимо к модемам Hilink
Write Only=Только запись
written by=написано
Wrong filename, the correct extension is=Неверное имя файла, допустимое расширение
Wrong nbw_cap=Недействительное nbw_cap
XMLHTTPRequest objects. This page requires=объекты XMLHTTPRequest. Этой странице необходим
Yes=Да
Yes, Authentication required=Да, с паролем
Yes, i do and want to make a choice=Да, знаю. Хочу сделать выбор
Yes, i`m sure i do=Да, включить TomatoAnon
Yes, LAN only=Да, только в локальной сети
Yes, no Authentication=Да, без пароля
Yes, WAN and LAN=Да, в Интернете и локальной сети
You can add other values to nginx.conf in declaration of http {} to suit your needs=Вы можете добавить дополнительные параметры к nginx.conf в разделе http {}
You can add other values to nginx.conf in declaration of server {} to suit your needs=Вы можете добавить дополнительные параметры к nginx.conf в разделе server {}
You can add other values to nginx.conf to suit your needs=Вы можете добавить дополнительные параметры к nginx.conf
You can add other values to php.ini to suit your needs=Вы можете добавить дополнительные параметры к php.ini
You can always re-enable it at any time=Выможете снова включить TomatoAnon в любое время
You can always re-enable it at any time=Вы так же можете снова включить его в любое время
You can check which version of Tomato is most commonly used and which one is the most stable=Вы можете уточнить, какая версия Томато наиболее часто используется и стабильна
You can check which version of Tomato is most commonly used and which one is the most stable=Вы можете посмотреть, какая версия Томато наиболее часто используется и наиболее стабильна
You can find more information on proper NFS configuration at the following website=Вы можете ознакомиться с информацией по настройке NFS на сайте
You can now unplug the router=Теперь вы можете отключить роутер
You did not configure=Вы ещё не сконфигурировали
You may continue anyway but remember=Вы можете продолжить, но помните
You may need to release then renew your computer's DHCP lease before continuing=Вам может потребоваться обновить IP-компьютера для продолжения
You need a div or span element=Необходим элемент <i>div</i> или <i>span</i>
you was warned=Вы были предупреждены
######################################
### RU lang for Advanced Tomato UI ###
######################################
24h Bandwidth History=Загрузка сети за сутки
24h IP Traffic History=Статистика IP за сутки
3G or LTE mode can be set only to one WAN port=Режим 3G/4G может быть применён только к одному WAN-соединению
Admin Access Settings=Настройки доступа и интерфейса
Advanced MAC Settings=Настройки MAC-адресов
AdvancedTomato logo by Jacky=Лого AdvancedTomato от Jacky
AdvancedTomato version=AdvancedTomato версии
Allowed Remote<br>Address(es)=Разрешенные IP-адреса
Allowed Remote IP Address=Разрешенные IP-адреса
Although technically supported, it's not actually recommended having IP Traffic monitoring enabled with subnets larger than/the equivalent of a class C network=Хотя технически это возможно, не рекомендуется включать статистику IP для подсетей больших чем сеть класса C
Amber SES=Оранжевый SES
and make sure the netmask on any/all of your LAN bridges has been configured properly=и удостоверьтесь, что маска подсети моста(ов) LAN указана правильно
Announce IPv6 on LAN=Анонсировать IPv6 в LAN
A Only=Только A
As a rule of thumb, this means keeping track of network/data packets being forwarded from/to LAN interfaces as a result of some kind of routing (or NAT) and would exclude any/all data/packets being exchanged between devices reachable/within the same LAN interface (i.e. on the same IP subnet/LAN bridge, even if packets are actually being forwarded from/to wired/wireless/different interfaces through the router)=Это так же означает, что учитываются данные, прошедшие между различным интерфейсами, и не учитываются данные, переданные между устройствами, подключенными к одному и тому же интрефейсу (из одной LAN-подсети/моста, несмотря на то, что такие данные так же передаются между к примеру проводными и беспроводными клиентами на разных интерфейсах)
as in: number of bytes/packets <i>coming from</i> the first LAN bridge and (the same) number of bytes/packets <i>going to</i> the second LAN bridge=а именно: количество Байт, полученных из первого LAN-моста и (это же) количество Байт, пришедших на второй LAN-мост
Authentication is <b><i>highly recomended</i></b>. GUI will prompt for user/pass=Рекомендуется <b><i>включить авторизацию</i></b>. При обращении к интерфейсу управления будет запрошен логин и пароль
Authorization Settings=Настройки авторизации
Auto refresh graphs=Авто-обновление
available=доступно
Based on Tomato by Shibby=Основано на работе Shibby
Basic Forwarding=Основные правила
Basic IPv6 Configuration=Основные настройки IPv6
Basic IPv6 Forwarding=Основные правила IPv6
Basic Network Settings=Основные настройки сети
Basic QOS Settings=Основные настройки QoS
before enabling this feature: any/all LAN interfaces must have a netmask with at least 16 bits set (255.255.0.0)=перед включением: все локальные подсети должны иметь маску подсети не менее 16 бит (255.255.0.0)
Before enabling this feature, please check your=Перед включением этой фунуции, пожалуйста, проверьте
before flashing any images to your router=перед обновлением прошивки роутера
B/G Mixed=Смешанный B/G
Blacklists=Списки блокировки
B Only=Только B
browser window might help=страницы в браузере может исправить ситуацию
Buttons/LED=Кнопки/индикаторы
B/W Limiter= Скорость LAN
By definition, configuration settings for the <i>primary VIF</i> of any physical wireless interfaces shouldn't be touched here (use the=Настройки главного виртуального интерфейса для любого физического интерфейса Wi-Fi не должны меняться в этом разделе (используйте страницу
By using this process and learning if image is corupted or not, you will eliminate many issues with the upgrade process=Это позволит избежать большинства проблем, которые могут возникнуть в результате неудачного обновления
Check your=Проверьте
CIFS1 Usage=Использов. CIFS1
CIFS2 Usage=Использов. CIFS2
Classification Rules=Правила классификации
Clear Log=Очистить журнал
Click here to find out more=Дополнительные сведения
Collapsed=Свёрнуто
Common Name (CN)=Имя (CN)
Complete interface re-design=Современный WEB-интерфейс
Configure Logging=Настрока журнала
Configure Settings=Настроить параметры
Connected=Подключено
Conntrack/Netfilter=Соединения/NAT
count=число
Custom List=Свой список
Custom splash file=Выберите splash-файл
Cyan Color Scheme=Сине-зелёная тема
Daily Bandwidth=Загрузка сети по дням
Daily IP Traffic=Статистика IP по дням
Debugging Settings & Information=Настройки отладки и информация
Default Navigation State=Состояние меню по умолч.
Default (NTLM)=По умолчанию (NTLM)
default (random) set 0=по умолчанию (0) произвольный порт
Devices List=Список устройств
Direct clients to<br>redirect Internet traffic=Указывать клиентам<br>перенаправлять трафик Интернета
Disconnected=Отключено
DMZ Forwarding=Настройка DMZ
DMZ Settings=Настройки DMZ
Do not interrupt browser or the router!=Не закрывайте браузер и не выключайте роутер!
Download (bytes/s)=DL (байт/с)
DSCP (any)=Любой DSCP
Dynamic DNS Service=Сервис динамического DNS
Enable if this is a new file=Включите для создания нового файла
Enable QoS=Включить QoS
Enable static ARP for=Включение постоянной ARP-записи для
Enable this option if you need more than one NAS process running (i.e. to handle WPAx encryption on more than one WLVIF)=Включите, если необходимо более одного NAS (например, для обеспечения шифрования WPAx на нескольких виртуальных интерфейсах Wi-Fi)
enable web monitoring=включите Монитор соединений с Интернетом
Enabling this may cause HIGH CPU usage=Включение этой опции может повлечь высокую загрузку процессора
Enforce static ARP binding for all IP/MAC address pairs listed above=Обеспечивает соотвествие IP/MAC для адресов из таблицы выше
Event Scripts=Скрипты событий
ex:=прим.
Excluded ports=Исключенные порты
Excluded URLs=Исключенные URL-адреса
Experts only! This will change directory from which Tomato Web handler is reading the interface files from. You should only change this if you have another interface in specific directory=Только для экспертов! Эта настройка меняет директорию, в которой находятся веб-страницы интерфейса. Меняйте этот параметр только в случае, когда у вас есть альтернативная директория с веб-интерфейсом Томато.
Extended HW support, thanks=Расш. список роутеров, спасибо
Firewall Settings=Настройки брандмауэра
first/last=от/до
for infinite=для непрерывного цикла
Formating JFFS partition, please wait=Идет форматирование JFFS, подождите
GHz=ГГц
G Only=Только G
Go to Status Overview=Перейти к странице состояния роутера
Green Color Scheme=Зелёная тема
has been released and it is available for download=доступна для загрузки
HFS+ FS r/w integration=Полная поддержка HFS+
Hide/Show=Свернуть/Развернуть
Hide/Show Notes=Свернуть/Развернуть
How often the ARP cache will be checked=Частота проверки таблицы ARP
HTTP Only=Только HTTP
ICMP IN/OUT (pkt/s)=TCP ВХ/ИСХ (п/с)
i.e. netmask with at least 16 bits set or=то есть содержит как минимум 16 бит или
i.e. netmask with at least 24 bits set or=то есть с маской подсети 24 и более бит или
if not defined on Basic/Network page=если не указан в «Основные настройки»/«Сеть»
IGMPproxy must be enabled in least one LAN bridge=IGMPproxy должен быть включен хотя бы для одного моста LAN
Ignore DHCP requests=Игнорировать DHCP-запросы
IMQ based QOS Ingress=Основанный на IMQ QoS
Included ports=Разрешенные порты
Incoming Class Bandwidth pie chart=Диаграммы QoS
in order to view information on this page=для отображения информации на этой странице
In private mode, the root directory is the directory under the=В приватном режиме корневой директорией является папка внутри
Interface Settings=Настройки интерфейса
Interface Theme=Оформление
Invalid IP address or subnet mask (conflicts/overlaps with another LAN bridge)=Недопустимый IP-адрес или маска подсети (пересекается с другим мостом LAN)
Invalid IP address or subnet mask (the address of the network cannot be used)=Недопустимый IP-адрес или маска подсети (нельзя испольовать адрес сети)
Invalid IP address or subnet mask (the broadcast address cannot be used)=Недопустимый IP-адрес или маска подсети (нельзя использовать адрес броадкаста)
IP (Hostname)=IP (имя хоста)
IP&nbsp;Range=Диапазон&nbsp;IP
IPP2P (disabled)=IPP2P (отключено)
IP:port=IP:порт
IP Traffic Graphs=Диаграммы IP
IP Traffic is about monitoring <i>IPv4</i> network traffic flowing <i>through</i> the router=Статистика IP собирает информацию об <i>IPv4</i> трафике, прошедшем <i>через</i> роутер
IP Traffic monitoring keeps track of data/packets that would be either <i>coming from/leaving</i> or <i>going to/arriving</i> IPs on LAN interfaces/subnets=Статистика IP хранит данные об пакетах, которые <i>пришли от</i> или <i>были получены для</i> IP-адресов LAN интерфейсов/подсетей
IP Traffic Monitoring Settings=Настройки статистики IP
is used=будет использоваться по умолчанию
JFFS Partition=Раздел JFFS
JFFS Usage=Использов. JFFS
KB=КБ
LAN Access Settings=Настройки доступа в LAN
LAN Settings=Настройки сети
Layer 7 (disabled)=Layer 7 (отключено)
Lease&nbsp;Time=Срок&nbsp;аренды
Leave a blank space between each port number. Use only one of these two options to avoid conflicts=Используйте пробел для разделения портов. Во избежание конфликтов используйте только одну из этих двух опций
Limit PPS=Ограничить PPS
Login Timeout=Длительность сесии
Manage MySQL via Adminer=Управление MySQL БД через Adminer
MB=МБ
Mbps=Мбит/с
Memory Usage=Использов. памяти
Miscellaneous Settings=Настройки оборудования
Monitoring of larger subnets is not supported=Монитор IP больших сетей не поддерживается
Monthly Bandwidth=Загрузка сети по месяцам
Monthly IP Traffic=Статистика IP по месяцам
Move=Переместить
ms=мс
Must also be defined in the Hosts area=Должно быть определено в разделе «Hosts»
mW=мВт
NAT-PMP or UPnP must be enabled in least one LAN bridge. You may continue but remember to configure an access to UPnP service by Custom Configuration=NAT-PMP или UPnP должен быть включен хотя бы для одного моста LAN. Вы можете продолжить, но не забудьте включить досуп к службе UPnP в блоке «Включено для» позднее
Navigation Menu=Меню навигации
Netmask should have at least 22 bits (255.255.252.0). You may continue anyway but remember - you was warned=Маска подсети должна быть хотя бы 22 бита (255.255.252.0). Вы можете продолжить, но помните - Вас предупреждали
Network traffic/communications flowing from/to/between different LAN bridges/subnets will be tracked/accounted separately/accordingly=Сетевой трафик между разными LAN-подсетями/мостами учитывается независимо
N Only=Только N
NTLM and packet signing=NTLM с подписью
NTLMv2 and packet signing=NTLMv2 с подписью
NVRAM Usage=Использов. NVRAM
One VID <i>must</i> be assigned to WAN=Один VID <i>должен</i> быть назначен порту WAN
One VID <i>must</i> be selected as the default=Один VID <i>должен</i> быть установлен по умолчанию
Only connections to destination port 80 are redirected to TOR=Только соединения по 80 порту будут перенаправлены через TOR
Orange Color Scheme=Оранжевая тема
or invalid domain name=или неправильно указан домен
page instead)=вместо этой)
password is mandatory=пароль обязателен
Per-Connection Transfer Rates=Скорость передачи QoS
Please=Пожалуйста
Please wait while new firmware is being uploaded and flashed=Пожалуйста, дождитесь окончания загрузки и применения обновления
Please wait while the defaults are restored=Пожалуйста, дождитесь восстановления настроек по умолчанию
Port / Application=Порт / Приложение
Port Numbers on Router Case (Left -> Right viewed from Front)=номера портов на роутере (слева направо)
QoS BW Limiter=Ограничить скорость (QoS)
QOS Classification Rules=Правила классификации QoS
QOS Details=QoS - Подробно
QoS is disabled=QoS отключен
QOS Transfer Rates=Скорость передачи QoS
Quality (%)=Качество&nbsp;(%)
Quality of Service=Quality of Service
RAM (Temporary)=В памяти (временное)
Real Time Bandwidth=Загрузка сети в реальном времени
Real-Time Bandwidth=Загрузка сети в реальном времени
Real Time IP Traffic=Статистика IP в реальном времени
Rebooting, please wait=Выполняется перезагрузка. Пожалуйста, подождите
Red Color Scheme=Красная тема
Redesigned AT interface=Изменённый AT-интерфейс
Refreshing=Обновление
Reload Information=Обновить инфо.
Repeat Password=Повторите ввод
Restore defaults=Очистка памяти
re-vectored by=переделанное
Revised Multi-Language support=Поддержка неск. языков
Router Configuration=Конфигурация роутера
Router Info=Информация о роутере
Router IP Address=IP-адрес роутера
Router Logging=Журналы системы
Router Logs=Файлы журнала
Router Scripts=Скрипты
Router Upgrade=Обновление прошивки
Running=Запущен
/s=/c
s.=с.
Save state when IP changes (nvram commit)=Сохранять состояние при изменении IP (в nvram)
SDHC integration and GUI=Подержка SDHC
Search through available log files for specific text and display matched rows=Поиск в журнале и вывод совпадающих строк
Select new image=Выберите файл обновления
Select one of the bridges on which the Captive Portal will listen=Укажите мост, на котором будет использоваться Портал
Source Address Restrictiones=Ограничить по источнику
Spanning-Tree Protocol=Протокол Spanning-Tree (STP)
Start now=Запустить
Start PPTP Client=Запустить&nbsp;PPTP-кл.
Start VPN Client=Запустить VPN-кл.
Start VPN Server=Запустить VPN
Static DHCP/ARP & Bandwidth Monitoring of LAN Clients=Настойка DHCP/ARP и статистики IP
Static DHCP/ARP/BW=Постоянные назначения DHCP/ARP/BW
Status Overview=Состояние роутера
Stop now=Остановить
Stopped=Остановлен
Stop PPTP Client=Остановить&nbsp;PPTP-кл.
Stop VPN Client=Останов. VPN-кл.
Stop VPN Server=Останов. VPN
strongest=ближайший
swap=SWAP
SWAP Usage=Использов. SWAP
TCP Connections=Соединения TCP
TCP IN/OUT (pkt/s)=TCP ВХ/ИСХ (п/с)
TCP ports to allow access to after login, all others will be denied=TCP-порты, доступные после авторизации. Все остальные будут заблокированы
TCP ports to denied access to after login, all others will be allowed=TCP-порты, заблокированные после авторизации. Все остальные будут разрешены
The bandwidth will be shared by all hosts in=Полоса будет разделена между всеми клиентами в
The bandwidth will be shared by all unlisted hosts in=Полоса будет разделена между всеми остальными клиентами в
The client can use the internet until this time expires=Время работы Интернета после авторизации
The location where the Welcome banner is stored=Расположение страницы приветствия
The port number of the gateway=Номер порта на роутере
There has been many reports how AdvancedTomato did not flash well or it came with many bugs. Reason for that is bad image files which can sometimes get corupted at the download process.=Как правило проблемы с обновлением вызваны не полностью загруженным файлом прошивки.
The router will reset its address back to 192.168.1.1=Роутер вернет собственный IP-адрес 192.168.1.1
The router will show a Welcome banner when a client attempts to access the Internet=При выборе этой настройки, на компьютере пользователя будет отображаться баннер при подключении к Интернету
These issues usually occur when file is missing or router is unavailable to accept new connections=Это обычно происходит, если роутер не доступен или не принимает новые соединения
The URL for the 'Home Page' mentioned above is located=URL домашней страницы
This message is here to warn you to check MD5 checksum=Настоятельно рекомендуется проверить контрольную сумму MD5
This option allows you to add custom navigation links or rewrite existing ones. Only JSON format accepted=Включение этой опции позводит добавить собственные пункты меню навигации или переопределить существующие. Допускается только JSON
This web interface allows configuring a maximum of 4 VIFs for each physical wireless interface available - up to 3 extra VIFs can be defined in addition to the primary VIF (<i>on devices with multiple VIF capabilities</i>)=Вы можете настроить до 4-х виртуальных интерфейсов для каждого физического интерфейса Wi-Fi. До 3-х дополнительных виртуальных интерфейсов может быть добавлено к основному (<i>на устройствах, поддерживающих эту функцию</i>)
Toggle Collapsed Navigation=Переключить вид меню
Tor Project=Проект TOR
Tor Project Settings=Настройки The Onion Router
Torquoise Color Scheme=Бирюзовая тема
Trace Route=Трассировка маршрута
Triggered Forwarding=Настройка триггеров
twice=дважды
UDP Connections=Соединения UDP
UDP IN/OUT (pkt/s)=UDP ВХ/ИСХ (п/с)
Unable to connect to the interface=Не удалось подключиться к интерфейсу управления
!! Unknown Port Mapping Using Default !!=Не удалось определить роутер! Применены стандартые значения!
Unlisted MAC addresses won't be able to obtain an IP address through DHCP=Отсутствующие в списке MAC-адреса не смогут получить настройки от DHCP-сервера
Update Available=Обновление доступно для загрузки
Upgrade forbidden=Обновление запрещено
Upload (bytes/s)=UL (байт/с)
UPnP / NAT-PMP Forwarding=Порты UPnP / NAT-PMP
UPnP / NAT-PMP Port Forwarding=Порты UPnP / NAT-PMP
USB audio ready fw (GUI)=Поддержка звуковых карт
USB & NAS=USB и NAS
Use .incomplete/=Использ. директорию .incomplete
Use the command &quot;nvram show&quot; or &quot;nvram show | grep qos&quot; to cut and paste configuration=Вы можете использовать команду &quot;nvram show&quot; или &quot;nvram show | grep qos&quot; etc. для копирования настроек nvram
Various color schemes=Поддержка цветных тем
Verbosity level for log messages from this module, Level=Уровень детализации сообщений в логе:
View Router Logs=Посмотреть журнал
VLAN Settings=Настройки VLAN
VLANs section only=в разделе VLANs
VPN Client=VPN-клиент
VPN Server=Сервер VPN
Wake on Lan=Пробуждение по сети
Wake On Lan=Пробуждение по сети
Warning: 10 second session timeout, restarting=Предупреждение: нет данных 10 секунд, перезапуск
Web GUI directory=Директория веб-интерфейса
Web Services=Веб-сервисы
Weekly Bandwidth=Загрузка сети по неделям
When active, a 'Home Page' will appear after you click 'Agree' in the Welcome banner=Если включено, после нажатия «Agree» будет показана домашняя страница (см. следующий параметр)
When creating/defining a new wireless VIF, it's MAC address will be shown (incorrectly) as '00:00:00:00:00:00', as it's unknown at that moment (until network is restarted and this page is reloaded)=При создании нового виртуального Wi-Fi интерфейса, его MAC-адрес будет отображаться (не корректно) как «00:00:00:00:00:00», поскольку в настоящий момент он не известен (пока не перезагрузится сеть и эта страница)
When no directory is specified, /mnt is used as a root directory=Когда не указана директория, <b>/mnt</b> используется как корневая директория
When no Root Directory is specified for the user, the default=Если не определено, то
When saving changes, the MAC addresses of all defined non-primary wireless VIFs could sometimes be (already) <i>set</i> but might be <i>recreated</i> by the WL driver (so that previously defined/saved settings might need to be updated/changed accordingly on=При сохранении изменений, MAC-адреса всех дополнительных виртуальных интерфейсов Wi-Fi могут быть (уже) определены, но перезаписаны драйвером (таким образом, необходимо проверить/обновить настройки на странице
When the client's lease has expired, he must enter the Splash page again to get a new lease. No warning is given, therefore you may wish to give a long lease time to avoid problems.=По окончании времени сессии, клиенту нужно заново попасть на экран приверствия для получения новой сессии. Не существует предупреждения об окончании текущей сессии, но можно указать большую длительность для избежания подобных ситуаций.
White SES=Белый SES
Wireless Client mode can be set only to one WAN port=Режим Wi-Fi клиент может быть применён только к одному WAN-соединению
Wireless Client mode requires a valid WAN setting (usually DHCP)=Режим беспроводного клиента требует настроенного порта WAN (как правило по DHCP)
Wireless Client must be setup in WAN section=Беспроводной клиент включается в секции WAN
Wireless connections to this router may be disrupted while using this tool=Текущие беспроводные соединения могут быть прерваны в процессе работы данного приложения
With AdvancedTomato you get very few built in skins, others are available on AdvancedTomato Themes Directory. This way we can save space on router for more important functions.=В AdvancedTomato существует всего несколько тем. Это позволяет сэкономить место в памяти для более важных функций.
with the name matching the name of the user=с именем подключенного пользователя
Working, please wait=Обработка, пожалуйста, подождите
You can always toggle navigation style by clicking an icon right to logo, but doing so won`t change default state=Вы всегда можете переключить вид меню, нажав на иконку рядом с логотипом, но это действие не меняет положение по умолчанию
You did not configure <b>TomatoAnon project</b> setting=Вы не настроили <b>TomatoAnon</b>
You may need to renew your computer's DHCP or reboot your computer before continuing=Вам может потребоваться перезагрузить ваш компьютер или заново запросить IP-адрес по DHCP для продолжения работы
Zoom Graphs=Увеличить графики
