0 to disable=0代表禁用
10 minute window, 2 second interval=10分钟窗口，2秒间隔
2 minute interval=2分钟间隔
24h Bandwidth History=24小时带宽历史
24h IP Traffic History=24小时IP流量历史
3G Modem=3G调制解调器
3G Modem support=3G调制解调器支持
3G only=仅 3G
3G or LTE mode can be set only to one WAN port=3G或LTE模式只能设置一个WAN端口
4G only=仅 4G
4G/3G only=仅 4G/3G
4G/LTE Modem support=4G/LTE调制解调器支持
6in4 Static Tunnel=6in4静态隧道
6rd from DHCPv4 (Option 212)=6rd from DHCPv4 (Option 212)
6RD IPv4 Mask Length=6RD IPv4掩码长度
6rd Prefix Length=6rd 前缀长度
6rd Relay=6rd转发
6rd Routed Prefix=6rd 路由前缀
6RD Tunnel Border Relay (IPv4 Address)=6RD Tunnel Border Relay (IPv4地址)
6to4 Anycast Relay=6to4 Anycast Relay
802.11n Preamble=802.11n报头
!! Unknown Port Mapping Using Default !!=!! 不清楚端口映射请使用默认值 !!
A Only=仅A
About=关于
about 60 seconds=大约60秒
About TomatoAnon Project=关于TomatoAnon项目
about&nbsp;=大约&nbsp;
Absolute maximum amount of time allowed for any DHCP lease to be valid=最大DHCP租约时间
Accept DNS configuration=接受DNS配置
Accept RA from=接受RA自
Acceptable=可接受的
Access=访问
Access Level=访问级别
Access Point=接入点
Access Point + WDS=接入点+ WDS
Access Restriction=访问限制
Access Restriction Overview=访问限制一览
Access Restrictions=访问限制
Action=动作
active=活动的
Active=活动的
actual max depends on Country selected; use 0 for hardware default=最高值取决于所选择的区域; 0为默认值
Adaptive=自适应
Add=增加
Add DNS servers received from your WAN connection to the static DNS server list=从WAN接收到的DNS服务器地址将会添加到静态DNS服务器列表
added=已增加
Additional=额外的
Additional Shares List=共享列表
Address=地址
Address must be supplied when ConnectTo is checked=当“"连接到”被选中时必须提供地址
Address to be used at the local end of the tunnelled PPP links between the server and the VPN clients=用于服务端和VPN客户端的PPP链接隧道的本地末端的地址
Addresses must be unique=地址必须唯一
Admin=管理
Admin Access=管理员访问
Admin Access Settings=管理员访问设置
Admin Restrictions=访问限制
Administration=系统管理
Advanced=高级设置
Advanced DHCP/DNS=高级DHCP/DNS
Advanced MAC Settings=高级MAC设置
Advanced Settings=高级设置
AdvancedTomato version=AdvancedTomato 版本
Advertise DNS to clients=向客户端发布DNS
Advised to turn off PIN Code=建议关闭PIN码
Africa=非洲
After configuring this VIF, review and save your settings on the Overview tab=配置完VIF之后,请审查概览选项卡上的设置并保存
After flashing, erase all data in NVRAM memory=更新后，清除NVRAM中所有数据
after saving settings and rebooting your router=保存更改并重新启动路由器
after saving settings and rebooting your router)=保存更改并重新启动路由器）
All=全部
All Computers / Devices=所有计算机 / 设备
All Day=全天
All Except=所有的除了
All IPP2P filters=所有IPP2P过滤器
All IPP2P Filters=所有IPP2P过滤器
All Media Files=所有媒体文件
all ports=所有端口
Allow Admin Login=允许管理员登录
Allow Anyhost to access=允许任意主机访问
Allow Client<->Client=允许客户端<->客户端
Allow dnsmasq to be your DNS server on LAN=允许dnsmasq作为你的局域网DNS服务器
Allow Only These Clients=仅允许这些客户端
Allow Only User/Pass(Without cert) Auth=仅允许用户名/密码（无需证书）认证
Allow Password Login=允许密码登陆
Allow remote access=允许远程访问
Allow Remote Access=允许远程访问
Allow User/Pass Auth=允许用户名/密码认证
Allow web login as=允许登陆用
Allow Wireless Access=允许无线访问
Allowed any hosts to access database server=允许任何主机访问数据库服务器
Allowed Remote=允许远程
Allowed Remote IP Address=允许远程的IP地址
Allowed Remote<br>Address(es)=允许远程<br>地址
Allows configuring extra WINS servers for VPN clients, in addition to the WINS server defined on=允许为VPN客户端配置额外的WINS服务器,除了WINS服务器
Allows defining DNS servers manually (if none are set, the router/local IP address should be used by VPN clients)=允许手动定义DNS服务器(如果没有设置,那么VPN客户端会使用路由器/本地的IP地址)
Allows overriding 'traditional' VLAN/VID mapping with arbitrary VIDs for each VLAN=每个VLAN允许用任意VIDs覆盖“传统”的VLAN / VID映射
Allows users to connect with admin account=允许用户以管理员帐户连接
Although technically supported, it's not actually recommended having IP Traffic monitoring enabled with subnets larger than/the equivalent of a class C network=虽然在技术上是可行的，但不建议IP流量监控的子网大于C类网络
always enabled for Admin=始终为管理员启用
Amber=琥珀
Amber SES=琥珀色SES
Amplifier=放大器
An upgrade may overwrite the JFFS partition currently in use. Before upgrading, please backup the contents of the JFFS partition, disable it, then reboot the router=升级可能覆盖当前使用的JFFS分区。升级之前，请备份JFFS分区内容，禁用它并重启路由器
and=和
and any integer up to 9 (best zlib), 10 (fast lzo) and 11 (best lzo)=和任何整数到 9(最好zlib) 10(快速lzo)和 11(最佳lzo)
and Broadcom Wireless Driver=和博通无线驱动
and make a choice=进行选择
and make sure the netmask on any/all of your LAN bridges has been configured properly=并确保网络掩码在任何/所有的LAN网桥已被正确配置
and packet signing=和数据包签名
and spaces are allowed=和空格
Announce IPv6 on LAN=在局域网发布IPv6
Announce IPv6 on LAN (DHCP)=在局域网(DHCP)发布IPv6
Announce IPv6 on LAN (SLAAC)=在局域网(SLAAC)发布IPv6
Anonymous Root Directory=匿名根目录
Anonymous Users Access=匿名用户访问
any=任意
Any=任意
Any Address=任意地址
Any DNS requests/packets sent out to UDP port 53 are redirected to the internal DNS server=任何发送到UDP端口53的DNS请求/数据包会被重定向到内部DNS服务器
Any Port=任意端口
Any Protocol=任何协议
AP Isolation=AP隔离
APC UPS Response=APC UPS响应
APC UPS Status=APC UPS状态
APCUPSD integration and GUI=APC UPS支持和GUI
AppleJuice=AppleJuice
Application=应用程序
Applies To=适用于
Apr=四月
aprox. size that can be buffered completely in RAM=所有能用作缓冲的RAM近似大小
APSD Mode=APSD模式
are=
are allowed=是被允许的
are not allowed=是不被允许的
Are you sure the file=你是否确定这个文件
Are you sure you want to upgrade using=你是否确认要用此文件更新：
Are you sure?=确定吗？
area=范围
As a rule of thumb, this means keeping track of network/data packets being forwarded from/to LAN interfaces as a result of some kind of routing (or NAT) and would exclude any/all data/packets being exchanged between devices reachable/within the same LAN interface (i.e. on the same IP subnet/LAN bridge, even if packets are actually being forwarded from/to wired/wireless/different interfaces through the router)=As a rule of thumb, this means keeping track of network/data packets being forwarded from/to LAN interfaces as a result of some kind of routing (or NAT) and would exclude any/all data/packets being exchanged between devices reachable/within the same LAN interface (i.e. on the same IP subnet/LAN bridge, even if packets are actually being forwarded from/to wired/wireless/different interfaces through the router)
as in: number of bytes/packets <i>coming from</i> the first LAN bridge and (the same) number of bytes/packets <i>going to</i> the second LAN bridge=as in: number of bytes/packets <i>coming from</i> the first LAN bridge and (the same) number of bytes/packets <i>going to</i> the second LAN bridge
as you can find in USB mount path=你可以在USB挂载路径上找到
ASCII characters=ASCII字符
Asia=亚洲
Assigned / Routed Prefix=分配 / 路由前缀
Assignments of wireless interfaces to different LAN briges. You should probably be using and/or check things on=应该分配无线接口到不同的局域网网桥。你应该使用和（或）检查在
at any time=任何时候
At least one NTP server is required=至少需要一个NTP服务器
Attached Devices=已连接的设备
Attention=警告
Attention! Must not use NAND for datadir and tmpdir=注意！不能使用NAND作为数据目录和临时目录
Audio only=仅音频
Aug=八月
Authentication is=身份验证是被
Authentication is <b><i>highly recomended</i></b>. GUI will prompt for user/pass=<b><i>强烈建议身份验证</i></b>。GUI会提示输入用户名/密码
Authentication required=需要认证
Authentication Type=认证类型
Authorization Mode=授权模式
Authorization Settings=授权设置
Authorized Keys=认证密钥
Auto=自动
Auto Daylight Savings Time=自动切换夏令时
Auto Expire=自动过期
Auto Refresh=自动刷新
Auto refresh every=自动刷新每
Auto refresh graphs=自动刷新图形
Auto resolve addresses=自动解析地址
Auto Update Time=自动更新时间
Automatic=自动
automatically include new IPs in monitoring as soon as any traffic is detected=一旦发现新的IP通讯自动进行监控
Automatically mount all partitions to sub-directories in=自动挂载所有分区子目录在
Automatically retrying in=自动重试在
Automount=自动挂载
Auto-share all USB Partitions=自动共享所有USB分区
available=可用
available entries=可用条目
available, total=可用，总共
avg=平均
Avg=平均
Avoid displaying LAN to router connections=不要显示局域网到路由器连接
Avoid performing an NVRAM commit=不要提交NVRAM修改
Avoid using this option when FTP server is enabled for WAN. IT PROVIDES FULL ACCESS TO THE ROUTER FILE SYSTEM=当FTP服务器对广域网启用的时候不要使用此选项，它提供了对路由器文件系统的完全访问权限！
B Only=仅B
B/G Mixed=B/G混合
B/W Limiter=带宽限制
Back=后退
Backup=备份
Backup Configuration=备份设置
Backup Directory=备份目录
Backup MX=备份MX
Bad id=错误的ID
Bad id=错误的ID
Bandwidth=带宽
Bandwidth Distribution=带宽分布
Bandwidth Distribution (Inbound)=带宽分布（入站）
Bandwidth Distribution (Outbound)=宽带分布（出站）
Bandwidth Limiter=带宽限制
Bandwidth Limiter for=宽带限制用于
Bandwidth Monitoring=带宽监控
Bandwidth monitoring disabled=带宽监控已禁用
Based on Tomato by Shibby=基于 Shibby Tomato
Based on Tomato Firmware=基于Tomato固件
Basic=基础设置
Basic Forwarding=基础转发
Basic IPv6=基础IPv6
Basic IPv6 Configuration=基础IPv6设置
Basic IPv6 Forwarding=基础IPv6转发
Basic Network Settings=基础网络设置
Basic QOS Settings=基础Qos设置
Basic Rate=基础速率
Basic Settings=基础设置
be assigned to WAN=被分配到WAN
Be patient. Starting the TOR client can take from several seconds to several minutes=耐心等待。启动TOR客户端可能需要几秒钟到几分钟
be selected as the default=被选定为默认
Beacon Interval=信标间隔
before amplification=放大前
Before disconnecting 3G Modem from USB port, remember to uncheck box. If modem used usbserial module, you have to reboot router before unplug modem=从USB端口断开3G调制解调器之前,记得取消选中框。如果使用调制解调器usbserial模块,重启路由器之前你必须拔掉调制解调器
Before enabling this feature, please check your=启用此功能前，请检查您
before enabling this feature: any/all LAN interfaces must have a netmask with at least 16 bits set (255.255.0.0)=启用此功能前：任何/所有的LAN接口必须有至少16位子网掩码（255.255.0.0）
before flashing any images to your router=升级路由器固件之前
Best lzo=最佳lzo
Best Regards=致以最亲切的问候
Best zlib=最佳zlib
Beta=Beta
Bi-directional=双向
Bidirectional copying=双向复制
big thanks for=大力感谢
BitTorrent Client=BitTorrent客户端
Black=黑色
Block All Internet Access=阻止所有互联网访问
Block the following clients=阻止以下客户端
Blocked Resources=阻止的资源
Blocklist=黑名单
Blue=蓝色
Bluetooth Coexistence=蓝牙共存
Boot Wait Time=启动等待时间
Both=两者
Both MAC address and name fields must not be empty=MAC地址和名称字段不能为空
Both passwords must match=两次输入的密码必须一致
Bound to=绑定到
Bridge=桥接
Bridge br0 must be always defined and have a valid IP address set=网桥br0必须定义并且有一个合法的IP地址
Bridge TAP with=桥接TAP到
Bridge WAN port to primary LAN=桥接WAN口到主LAN 
Bridge/Auto Switch=桥接/自动切换
Broadcast=广播
Broadcast Relay Mode=广播中继模式
browser window might help=浏览器窗口可能会有帮助
Browse=浏览
Built on=编译于
Builtype. Ex=编译类型。例如
but might be=但是可能
Buttons=按键
Buttons / LED=按键 / LED
Buttons/LED=按键 / LED
BW Limiter=带宽限制
bwlimit=带宽限制
By definition, configuration settings for the=根据定义,配置设置为
By definition, configuration settings for the <i>primary VIF</i> of any physical wireless interfaces shouldn't be touched here (use the=根据定义，对于任何Wi-Fi物理接口的 <i>主 VIF</i> 的设置不应在本节进行更改（使用
by the WL driver=被WL驱动
By using this process and learning if image is corupted or not, you will eliminate many issues with the upgrade process=通过这种方法得知固件是否有问题，从而消除升级过程中的许多问题
bytes=字节
Bytes=字节
Bytes In=字节输入
Bytes Out=字节输出
called when any USB device is attached or removed=当任何USB设备连接或删除时调用
Cancel=取消
Cannot add another entry for bridge br=无法增加另外的输入到网桥br
Cannot add more than one entry with VID=不能添加多个条目的VID
Cannot proceed without setting a default VID=无法继续：必须设置一个默认VID
Cannot proceed: at least one user must be defined=无法继续：必须定义至少一个用户
Cannot proceed: one and only one VID must be assigned to the primary LAN=无法继续：有且仅有一个VID必须分配给主LAN
Cannot proceed: one VID must be assigned to WAN=无法继续：一个VID必须被分配到WAN
Cannot proceed: two or more LAN bridges have conflicting IP addresses or overlapping subnets=无法继续：两个或两个以上局域网网桥存在冲突的IP地址或者重叠的子网
Cannot push routes if they`re not given. Please provide subnet/netmask=如果不提供路由则无法推送，请提供子网/网络掩码
Cannot set=无法设置
Cannot upgrade if JFFS is enabled=如果JFFS被启用则无法升级
Capabilities=功能
Captive Portal=网页认证
Captive Portal Management=网页认证管理
Captive Portal Management Settings=网页认证管理设置
Captive Portal. (Based in NocatSplash)=网页认证 (基于NocatSplash)
Captive Portal. User Guide=网页认证用户指南
Captive Site Forwarding=认证网站转发
Caution!=警告!
Caution! - If your router only has 32MB of RAM, you'll have to use swap=警告！ - 如果你的路由器只有32MB的内存，你必须使用交换区
Ceiling must be greater than or equal to rate=上限必须大于等于速度
Central / Eastern Europe=中欧 / 东欧
Certificate Authority=证书颁发机构（CA）
Ch=频道
Changes Saved=修改已保存
Channel=频道
Channel Width=频宽
character=字符
character. IP range is not supported=字符。不支持的IP范围
characters=字符
characters or less=个字符或更少
characters. Only one IP or Domain per entry=字符。只允许每行一个IP或域名
Check alive every=检查活动每
Check connections every=检查连接每
Check for ISP's that require only a Prefix Delegation (usually PPPoE (DSL,Fiber) connections)=检查ISP的要求只需要一个前缀授权（通常是PPPOE（DSL，光纤？）连接）
Checkout my router=检验我的路由器
Chipset=芯片
CIFS Client=CIFS客户端
CIFS1 Usage=CIFS1使用
CIFS2 Usage=CIFS2使用
Class=分类
Classification=分类
Classification Rules=分类规则
Cleaning Interval=清理间隔
Cleaning Threshold=清理阈值
Clear=清除
Clear Cookies=清除Cookies
Clear Data After Backup=备份后清除数据
Clear Log=清除日志
Click here to find out more=查看更多
Click here to hide=隐藏
Click here to manage MySQL=管理MySQL请点击这里
Click here to open Transmission GUI=点击此处打开Transmission
Click here to read more=点击了解更多
Click here to show=显示
Click OK/Login=单击“确定/登录”
Click to delete=单击删除
Click to edit=单击编辑
Click to wake up=点击唤醒
Click/select a device from this list to hide it=选择的设备将被隐藏
Click/select to show it again=选择的设备将被再次显示
Client=客户端
Client address pool=客户端地址池
Client Certificate=客户端证书
Client Codepage=客户端代码页
Client is not running or status could not be read=客户端未运行或无法读取状态
Client Key=客户端密钥
Client List=客户端列表
Clone PC=克隆PC
Close=关闭
Close Wait=等待关闭
Collapsed=收起
Color=颜色
Color Scheme=配色方案
Comcast DSCP Fix GUI=Comcast DSCP Fix GUI
comma separated list=逗号分隔列表
Comma separated list=逗号分隔的列表
Command=命令
Common Name=通用名称
Common Name (CN)=通用名称 (CN)
Common name cannot contain=通用名称不能包含
Common name is mandatory=通用名称是强制性的
compatible browsers may also exist=兼容的浏览器也可能存在
Complete interface re-design=界面完全重新设计
Comprehensive QOS rule examples set by default=默认的完整Qos示例
Compression=压缩
Computer's MAC Address=计算机的MAC地址
Config=配置
Configurable QOS class names=可配置的QOS分类名
configuration=设置
Configuration=设置
Configure=配置
Configure Logging=配置日志
Configure Settings=配置选项
conflicts/overlaps with another LAN bridge=与另一个网桥冲突/重叠
Connect=连接
Connect Mode=连接模式
Connect On Demand=按需连接
Connected=已连接
Connection Logging=连接日志
Connection retry=连接重试
Connection Type=连接类型
Connection Uptime=连接时间
connections=连接
Connections=连接
connections currently tracked=连接已跟踪
Connections Distribution=连接分布
ConnectTo=连接到
Conntrack / Netfilter=连接跟踪 / 网络过滤
Conntrack/Netfilter=连接跟踪 / 网络过滤
Console log level=控制台日志级别
Contact=联系
Content Filter=内容过滤
Continue=继续
Control Sideband=控制边带
Cookies Cleared=Cookies已清除
Copyright=版权
Core USB Support=USB支持
Count cache memory and buffers as free memory=将cache内存和buffer计入空闲内存
count current=当前数量
Country / Region=国家 / 地区
CPU Freq=CPU频率
CPU Load=CPU负载
CPU Usage=CPU使用率
Create Backups=创建备份
Create NAT on tunnel=创建隧道NAT
Create New File=创建新文件
Cron=Cron
CTS Protection Mode=CTS保护模式
Current DNS=当前的DNS
Current Routing Table=当前路由表
Current Version=当前版本
Custom=自定义
Custom configuration=自定义配置
Custom Configuration=自定义配置
Custom IP address=自定义的IP地址
Custom IP Address=自定义的IP地址
Custom log file path=自定义日志文件路径
Custom Log File Path=自定义日志文件路径
Custom Path=自定义路径
Custom Script=自定义脚本
Custom TZ String=自定义TZ字符串
Custom URL=自定义URL
Customized Splash File Path=自定义提示文件路径
Customized splash file=自定义提示文件
Custom splash file=自定义提示文件
Excluded URLs=排除的URL
Cut-Through Forwarding=直通转发
Cyan Color Scheme=青色配色方案
Cyrillic / Russian=西里尔文 / 俄罗斯
D Port=目标端口
Daily=每日
Daily Backup=每日备份
Daily Bandwidth=每日带宽
Daily History=每日历史
Daily IP Traffic=每日IP流量
Data=数据
Data and tmp dir.=数据和临时目录
Data and tmp dir.=数据和临时目录
Data current as of=当前的数据
Data dir.=数据目录
Data Directory=数据目录
Database Location=数据库位置
Date=日期
Date Format=日期格式
Date Range=日期范围
days=天
Days=天
DDNS=DDNS
DDNS update is running. Please refresh after a few seconds=正在更新DDNS，请几秒钟后刷新
Debugging=调试
Debugging Settings & Information=调试设置和调试信息
Dec=十二月
default=默认
Default=默认
Default (NTLM)=默认 (NTLM)
default (random) set=默认（随机）设置
default (random) set 0=默认（随机）设置0
Default class=默认分类
Default Class=默认分类
Default Class for=默认分类用于
Default Class for unlisted MAC / IP's in=未列出的MAC/IP地址的默认分类用于
Default Gateway=默认网关
Default Navigation State=默认导航样式
Delay at startup=启动时延迟
Delete=删除
Delete All=全部删除
Delete all entries?=删除所有条目？
Delete Lease=删除租借
Delete this rule?=删除此规则？
deleting=删除中
Description=描述
Dest Address=目标地址
Dest Ports=目标端口
Destination=目标地址
Destination Address=目标地址
Destination address inside the LAN=局域网内的目标地址
Destination Interface=目标接口
Destination LAN bridge=LAN网桥目标
Details=详情
Determines if this VLAN ID should be treated as WAN, part of a LAN bridge or just left alone (i.e. member of a 802.1Q trunk, being managed manually via scripts, etc...)=请确认此VLAN ID是否应视为WAN、LAN网桥的一部分、否则保持原样(i.e. member of a 802.1Q trunk, being managed manually via scripts, etc...)
Device List=设备列表
Devices List=设备列表
DHCP / DNS=DHCP / DNS
DHCP / DNS Server=DHCP / DNS 服务器
DHCP Client=DHCP客户端
DHCP Routes=DHCP路由
DHCP will use the IP address of the router as the default gateway on each LAN=DHCP将使用路由器的IP地址作为每个LAN的默认网关
DHCPC Options=DHCP选项
DHCPv6 with Prefix Delegation=DHCPv6带前缀授权
Diffie Hellman parameters=迪菲赫尔曼参数
Direct clients to=定向客户端至
Direct clients to<br>redirect Internet traffic=定向客户端至<br>重定向Internet流量
Directories=目录
directory=目录
Directory=目录
directory is shared in Read Only mode=目录以只读模式共享
Directory Listings=目录列表
Directory name under mounted partition=挂载分区下的目录名
Directory with GUI files=GUI文件所在目录
disable=停用
Disable=禁用
Disable filter=禁用过滤
Disable Wireless=禁用无线
disabled=已停用
Disabled=已禁用
Disabled (recommended)=禁用(推荐)
Disabled for Anonymous=禁用匿名访问
Disconnect=断开
Disconnected=已断开
Disconnecting=断开中
Display=显示
Distance / ACK Timing=距离 / ACK时序
DL Rate=下载速度
DLCeil=下载上限
DLCeil must be greater than DLRate=下载上限必须大于下载速度
DLCeil must between 1 and 99999=下载上限必须在1到99999之间
DLRate=下载速度
DLRate must between 1 and 99999=下载速度必须在1到99999之间
DMZ Forwarding=DMZ转发
DMZ Settings=DMZ设置
DNS Port=DNS端口
DNS Server=DNS服务器
DNS Servers=DNS服务器
DNScrypt-proxy 1.4.0 integration and GUI=DNScrypt-proxy 1.4.0 + GUI
DNSCrypt-Proxy selectable/manual resolver=DNSCrypt-Proxy选择/手动解析
Dnsmasq will ignore DHCP requests to Only MAC addresses listed on the=Dnsmasq只会忽略掉DHCP请求对于那些在
Dnsmasq will ignore DHCP requests to Only MAC addresses listed on the=Dnsmasq只会忽略掉DHCP请求对于那些在
DNSSEC integration and GUI=DNSSEC + GUI
Do not interrupt browser or the router!=请勿关闭浏览器或中断路由器连接！
Do not interrupt this browser or the router=请勿关闭此浏览器或中断路由器连接
Do not restart the following process if they die=如果以下进程终止则不重启它们
Do Nothing=无
Do you know what TomatoAnon doing=你知道TomatoAnon在做什么吗？
Do you want enable TomatoAnon=你想要启用TomatoAnon吗
Do you want enable TomatoAnon=你想要启用TomatoAnon吗
Document Root Path=文档根目录路径
Domain=域
Domain Name=域名
Domains=域
Down=离线
Download=下载
Download (bytes/s)=下载 (bytes/s)
Download ceil=下载上限
Download CFE=下载CFE
Download directory=下载目录
Download Ip6tables Dump=下载Ip6albes Dump
Download Iptables Dump=下载Iptables Dump
Download limit=下载限制
Download Log File=下载日志文件
Download Logs=下载日志
Download NVRAM Dump=下载NVRAM Dump
Download rate=下载速度
Downloaded=已下载
Downloads queuing=下载队列
Drop Idle=释放闲置
DSCP (any)=DSCP（任意）
DSCP value=DSCP值
DSCP Value=DSCP值
Dst=目标
Dst Address=目标地址
Dst IP=目标IP
dst port=目标端口
Dst Port=目标端口
DTIM Interval=DTIM间隔
Dual-band and Wireless-N mode=双频和无线N模式
Duplicate hostname=重复的主机名
Duplicate IP address=重复的IP地址
duplicate IP or MAC address=IP或MAC地址重复
Duplicate MAC address=重复的MAC地址
Duplicate share name=重复的共享名称
Duplicate User=重复的用户
Duplicate user name=重复的用户名
During this period of time no Welcome banner will appear when you access to the device. Default=在这段时间内，你访问设备将不出现欢迎横幅
Dynamic DNS=动态DNS
Dynamic DNS Service=动态DNS服务
Ed25519 Private Key=Ed25519私钥
Ed25519 Private Key is required when Start With WAN is checked=如果选中同WAN一起启动，您必须指定一个Ed25519私钥
Ed25519 Public Key=Ed25519公钥
Ed25519 Public Key is required=您必须指定一个Ed25519公钥
Edges=边缘
Edit Access Restrictions=编辑访问限制
Efficient Multicast Forwarding=高效组播转发
Either both or neither subnet and netmask must be provided=要么提供子网和网络掩码，要么两者都不提供。
Email Address=Email地址
empty field means=留空默认为
Empty share name is not allowed=不允许空的共享名称
Enable=启用
Enable 802.1Q tagging of ethernet frames on a particular port/VLAN=在一个特定的端口/ VLAN上启用802.1Q标记的以太网帧
Enable at Startup=开机时启用
Enable Auto-Discovery=启用自动发现
Enable client statistics=启用客户端统计
Enable cprintf output to /tmp/cprintf=允许cprintf输出到/tmp/cprintf
Enable cprintf output to console=允许cprintf输出到控制台
Enable DDNS output to=允许DDNS输出到
Enable DMZ=启用DMZ
Enable DNS rebinding protection on Dnsmasq=在Dnsmasq上开启DNS重绑定保护
Enable DNSSEC=允许DNSSEC
Enable DSCP Fix=启用DSCP修复
Enable Encryption=启用加密
Enable File Sharing=启用文件共享
Enable FTP Server=启用FTP服务器
Enable function=启用功能
Enable Function=启用功能
Enable GUI=启用GUI
Enable if this is a new file=如果是新文件时则启用
Enable IGMPproxy=启用IGMPproxy
Enable Interface=启用接口
Enable Jumbo Frames=启用巨帧
Enable Limiter=启用限制
Enable MySQL server=启用MySQL服务
Enable NAT-PMP=启用NAT-PMP
Enable NFS Server=启用NFS服务器
Enable PHP support=启用PHP支持
Enable Ports State=显示端口状态
Enable QoS=启用QoS
Enable Server on Start=开机时启动服务
Enable SNMP=启用SNMP
Enable static ARP for=开启静态ARP用于
Enable SYN cookies=启用SYN Cookies
Enable TCP Vegas=启用TCP Vegas
Enable this option if you need more than one NAS process running=启用这个设置如果你有一个以上的NAS进程要使用
Enable this option if you need more than one NAS process running (i.e. to handle WPAx encryption on more than one WLVIF)=启用这个设置如果你有一个以上的NAS进程要使用（例如：在多个WLVIF上处理WPAx加密）
Enable TOR=启用TOR
Enable torrent client=启用BT客户端
Enable Udpxy=启用Udpxy
Enable UPnP=启用UPnP
Enable USB Partition=启用USB分区
enable web monitoring=开启网页监控
Enable Wireless=启用无线
Enabled=启用
Enabled on=启用在
Enabling this may cause HIGH CPU usage=启用此选项将导致高CPU占用
Enabling this option will turn on VPN channel encryption, but it might lead to reduced channel bandwidth=启用此选项将打开VPN通道加密,但可能会导致降低信道带宽
Encryption=加密
Encryption cipher=加密算法
Enforce static ARP binding for all IP/MAC address pairs listed above=对列表内的IP/MAC地址执行静态ARP绑定
Enforce static ARP binding of this particular IP/MAC address pair=对特定的IP/MAC地址执行静态ARP绑定
English=英语
Enhanced RX Sensitivity=增强的接收灵敏度
Erase all data in NVRAM memory (thorough)=彻底擦除NVRAM中所有数据
erase all data in NVRAM memory, and reconfigure the router manually=擦除NVRAM中所有数据，并手动重新配置路由器
Error=错误
ERROR=错误
Established=已建立
Ethernet Ports State=以太网端口状态
Europe=欧洲
Event Scripts=事件脚本
Events Logged=已记录事件
every=每
Every=每
Every 1 Day=每1天
Every 1 Hour=每1小时
Every 12 hours=每12小时
Every 12 hours=每12小时
Every 12 Hours=每12小时
Every 15 minutes=每15分钟
Every 2 Days=每2天
Every 2 hours=每2小时
Every 2 Hours=每2小时
Every 24 hours=每24小时
Every 24 hours=每24小时
Every 24 Hours=每24小时
Every 3 Days=每3天
Every 3 Hours=每3小时
Every 3 minutes=每3分钟
Every 30 minutes=每30分钟
Every 30 Minutes=每30分钟
Every 4 Days=每4天
Every 4 hours=每4小时
Every 4 Hours=每4小时
Every 5 Days=每5天
Every 5 Hours=每5小时
Every 5 minutes=每5分钟
Every 6 Days=每6天
Every 6 hours=每6小时
Every 6 Hours=每6小时
Every 7 Days=每7天
Every 8 hours=每8小时
Every 9 Hours=每9小时
every day at midnight=每天午夜
Every hour=每1小时
Every Hour=每1小时
Every minute=每1分钟
Every Week=每1周
Everyday=每天
ex=例如
Ex=例如
ex:=例如：
Example=例如
Examples=例如
Exclude from List=从列表中排除
Exclude gateway traffic=不包含网关流量
Exclude IPv4 broadcast=排除IPv4广播
Exclude IPv4 multicast=排除IPv4多播
Exclude these IPs=不包含这些IP
Excluded Interfaces=排除界面
Excluded IPs=排除的IP
Excluded Ports to be redirected=不需被重定向的端口
Excluded/Included ports to be redirected=不需要/需要重定向的端口
Exclusive=独占
Execute=执行
Execute System Commands=执行系统命令
Execute When Mounted=挂载后执行
Expecting a=需要一个
Expecting a list of ports or port range=应为一个端口或端口范围列表
Expecting a URL -- http://... or https://...=输入一个URL -- http://... 或者 https://...
Experts Only=仅限专业用户
Experts only! This will change directory from which Tomato Web handler is reading the interface files from. You should only change this if you have another interface in specific directory=仅限专业用户！这将改变储存Tomato Web界面文件的文件夹。除非你有另外的目录存在Web界面文件，否则不要更改。
Expire Scheduled=计划到期
Expired time where you can't access the device again.Default value=你无法再次访问设备的超时时间，默认值
Exports=出口
Ext Ports=外部端口
Extended HW support, thanks=扩展的HW支持, 感谢
Extended MOTD=扩展的MOTD
Extended Sysinfo=扩展的系统信息
External=外部
External Only=仅外部
Extra HMAC authorization=额外的HMAC授权
Extra options for the DHCP client=DHCP客户端的额外选项
Extra options to be added to the Dnsmasq configuration file=将被添加到Dnsmasq配置文件的额外选项
Failed to mount. Verify the device is plugged in, and try again.=无法挂载，验证设备是否插好，然后再试一次
Failover=故障切换
fast=快速
Fast lzo=快速lzo
Fast zlib=快速zlib
feature=功能
features=功能
Feb=二月
few ports=多个端口
file=文件
File Sharing=文件共享
File Systems Support=支持文件系统
Filter out this address=过滤这个地址
Filter out this IP=过滤这个IP
Filters=过滤
FIN Wait=FIN Wait
Find=查找
Find more peers using=找到更多的peers使用
Firewall=防火墙
Firewall Rules=防火墙规则
Firewall Settings=防火墙设置
Firmware Upgrade=固件升级
first=起始
First 802.1Q VLAN tag=第一个802.1Q VLAN标签
First Day Of The Month=每月第一天
Fixed wireless channel required in WDS mode=固定的无线频道需要WDS模式
Fixes Comcast incorrect DSCP=修复不正确的Comcast DSCP
Flash Size=Flash容量
for anonymous connections=匿名连接
for authenticated users access in private mode=为认证用户以私有模式访问
for authenticated users access, if not specified for the user=通过身份验证的用户访问,如果没有指定用户
for default=默认
for DHCP=为DHCP
For help generating keys, refer to the OpenVPN=如需关于生成密钥的帮助，请参考OpenVPN的相关资料
for IP 192.168.1.4 to 192.168.1.7=用于IP 192.168.1.4到192.168.1.7
for IP Range .4 to .7=用于IP范围 .4 到 .7
for one IP=用于一个IP
Force next update=强制下次更新
Format / Erase=格式化 / 擦除
Format the JFFS partition?=格式化JFFS分区？
Formating JFFS partition, please wait=正在格式化JFFS分区，请稍等
Forward only if from this address. Ex=如来自此地址则转发，例如
Forwarded Only=仅转发
Forwarded Ports=转发端口
Forwarded Ports=转发端口
Forwarded Ports are the WAN to LAN ports that are opened if the 'trigger' is activated=转发端口是从广域网到局域网端口转发，如果此“触发”是激活的
Forwarding=转发
Fragmentation Threshold=分段阈值
Frame Burst=帧突发
free=空闲
Free Memory=空闲内存
Frequent saving to NVRAM or JFFS2 is not recommended. Continue anyway?=不建议频繁地写NVRAM或JFFS2，继续吗
Fri=周五
Friday=周五
From=来自
From Source IP=从源IP
FTP Port=FTP端口
FTP Server=FTP服务器
FTP Server Configuration=FTP服务器配置
Full=完整
Full-Duplex=全双工
G Only=仅G
Gateway=网关
Gateway / Next Hop=网关 / 下一跳
Gateway name=网关名称
Gateway Name=网关名称
Gateway Port=网关端口
General Statistics=综合统计
Generate=生成
Generate Keys=生成秘钥
Generate Marker=生成记号
Generic=一般
Global peer limit=全局节点限速
Global Tunnel ID=Global Tunnel ID
Go to Status Overview=进入路由器的状态页
GPT support for HDD by Yaniv Hamo=HDD的GPT支持由Yaniv Hamo实现
Gray=灰色
GRE / PPTP=PPTP / GRE
Green=绿色
Green Color Scheme=绿色配色方案
Group Key Renewal=组密钥更新
GUI for Transmission=Transmission图形化界面
GUI will prompt for user/pass=GUI提示输入用户名/密码
Half-Duplex=半双工
has been released and it is available for download=已经发布并可以下载
Hash Table Size=Hash表大小
Have you modified the configuration file manually? Tick this box and changes will be maintained=你手动修改配置文件了吗?勾选这个方框，设置将会被保存
HDD Spindown=硬盘休眠
header=头
Hello=你好
Here you can upload your personal Welcome banner that will overwrite the default one=在此你可以上传你自定义的欢迎横幅，它会覆盖默认的设置。
hex or=Hex或
HFS / HFS+ filesystem integration=HFS / HFS+文件系统集成
HFS/HFS+ Driver=HFS / HFS+驱动
HFS+ FS r/w integration=HFS+ FS 读/写 集成
Hidden=隐藏
Hidden addresses=隐藏地址
Hidden Read / Write=隐藏 读/写
hide=隐藏
Hide=隐藏
Hide IPs without traffic=隐藏没有流量的IP
Hide/Show=显示/隐藏
Hide/Show Notes=显示/隐藏 注释
High=高
Highest=最高
highly recomended=强烈推荐
history=历史
Home page=主页
Home Page=主页
Homepage=主页
Host=主机
Host Name=主机名
Host Name is required=您必须指定主机名
Host Name is required when Start With WAN is checked=当“同WAN一起启动”勾选时需要填写主机名
Host or IP Address / Port=主机或者IP地址 / 端口
host-down=主机关闭
Hostname=主机名
Hostname / Group=主机名 / 组
hosts=主机
Hosts=主机
host-up=主机启动
Hotplug script=热插拔脚本
hour=小时
Hours=小时
HOWTO=教程
HTTP Only=仅HTTP
HTTP Port=HTTP端口
HTTP Request=HTTP请求
HTTP Requested Files=HTTP请求的文件
HTTP Section=HTTP Section
HTTPS Port=HTTPS端口
Human-readable nickname/label assigned to this device on the network=分配给网络上设备的可读昵称/标签
I would like to present you with a new project I've been working on, called TomatoAnon=我想给你推荐一个我一直在工作的新的项目,称为TomatoAnon
i.e. netmask with at least 16 bits set or=то есть содержит как минимум 16 бит или
i.e. netmask with at least 24 bits set or=то есть с маской подсети 24 и более бит или
i.e. to handle WPAx encryption on more than one WLVIF=例如：在多个WLVIF上处理 WPAx加密
i.e; USB Stick, Hard Drive or SSD=例如：USB设备，硬盘或者SSD
I`m not sure right now=我现在还不确定
ICMP IN/OUT (pkt/s)=ICMP 进/出 (pkt/s)
Identification=名称
Idle Timeout=空闲超时
If Allowed By Firewall=如果允许通过防火墙
If Blocked By Firewall=如果被防火墙封锁
If checked, privileges table will be forced to re-initialize by mysql_install_db=如果勾选此项，将会给予mysql_install_db强行初始化表的特权
If checked, root password will be forced to re-initialize=如果勾选此项,root密码将强制重新初始化
If enabled, mysqld will be checked at the specified interval and will re-launch after a crash=如果启用,mysqld将在指定的时间间隔重新检查,并在崩溃后重新启动
If enabled, this option will limit how many torrents can be downloaded at once=如果启用,该选项将限制有多少种子可以立刻下载
If enabled, this option will limit how many torrents can be uploaded/seeded at once=如果启用,该选项将限制有多少种子可以上传/做种
If enabled, transmission-daemon will be checked at the specified interval and will re-launch after a crash=如果启用,transmission-daemon将在指定的时间检查,并在崩溃后重启
if not defined on Basic/Network page=如果在基础设置/网络中未定义
If this VIF should be active and brought online=是否将这个VIF激活并在线
If you don't agree with this script, or do not wish to use it, you can simply disable it=如果你不同意这个脚本,或者不希望使用它,您可以禁用它
If you notice that the order of the Lan Ports are incorrectly mapped=如果你发现LAN口顺序没有被正确映射
If you want to mount an NFS share from other NFS Server, you can use the mount.nfs tool via telnet/ssh=如果你想从其他NFS服务器挂载NFS共享，您可以通过telnet/ssh使用mount.nfs工具
If your router only has 32MB of RAM, you'll have to use swap=如果你的路由器只有32MB的内存，你必须使用交换区
IGMPproxy must be enabled in least one LAN bridge=IGMPproxy必须在至少一个LAN网桥上开启
Ignore DHCP requests=忽略DHCP请求
Ignore DHCP requests (...)=忽略DHCP请求 (...)
Ignore DHCP requests from unknown devices=忽略来自未知设备的DHCP请求
Ignore inactive connections=忽略不活动的连接
Ignore inactive hosts=忽略不活动的主机
Ignore Redirect Gateway=忽略重定向网关
Images only=仅图片
implemented by=实现于
IMQ based QOS Ingress=基于QoS的IMQ
In ARP=在APR缓存里
in minutes=以分钟为单位
in minutes, 0 to disable=以分钟为单位，0代表禁用
in order to clean up all unused and obsolete entries=从而清除所有未使用的和废弃的数据项
in order to view information on this page=为了查看此页面上的信息
In private mode, the root directory is the directory under the=私有模式下，这个根目录是一个目录在
In private mode, the root directory is the directory under the 'Private Root Directory' with the name matching the name of the user=私有模式下，这个根目录是“私有根目录”下的和用户的名称相符的目录。
in seconds=以秒为单位
in seconds, -1 for default=以秒为单位，-1代表默认
in seconds; -1 for infinite=以秒为单位，-1代表无限
In the Download directory (Recommended)=在下载目录（推荐）
in this state=在此状态
IN/OUT=进/出
Inactive Rules Cleaning=清理非活动规则
Inbound=入站
Inbound Layer 7=入站Layer 7
Inbound Rates / Limits=入站 速度/限制
Include Router Brand/Model=路由的品牌/型号
Included IPs=包含的IP
Included Ports to be redirected=需要被重定向的端口
Incoming=流入
Incoming Class Bandwidth pie chart=入站带宽分类图表
Incorrect filename. Expecting a=错误的文件名。需要一个
Infinite=无限期
Info=信息
Init=初始化
input like:  param=参数，例如：  connect_timeout
Installed version of Tomato. Ex=路由器安装的版本。例如
Int Address=内部地址
Int Port=内部端口
Intercept DNS port=拦截DNS端口
Interface=接口
Interface mode: Access Point, WDS, Wireless Client, etc=接口模式:接入点、WDS、无线客户端,等等
Interface Settings=界面设置
Interface Status=接口状态
Interface Theme=主题
Interface Type=接口类型
Interference Level=干扰水平
Interference Mitigation=干扰消减
Internal=内部
Internal Address=内部地址
Internal logging disabled=内部日志已禁用
Internet Explorer 5 or better for Windows=Windows Internet Explorer 5或更高
invalid CIDR notation on IPv6 address=无效的IPv6地址CIDR表示法
Invalid domain name or IP address=无效的域名或IP地址
Invalid DSCP value. Valid range=无效的DSCP值。有效范围
Invalid DSCP value. Valid range=无效的DSCP值。有效范围
Invalid entry. Only characters=输入无效：仅限字符
Invalid entry: max 32 characters are allowed=输入无效：最大支持32个字符
Invalid filename=无效文件名
Invalid first IP address or subnet mask=开始地址或者掩码无效
Invalid hash or URL=hash或URL无效
Invalid hostname=无效的主机名
Invalid hostname. Only characters=无效的主机名。仅允许字符
Invalid hostname/address=无效的主机/地址
invalid IP address=无效的IP地址
Invalid IP address=无效的IP地址
Invalid IP address or port=无效的IP地址或端口
Invalid IP address or subnet mask=无效的IP地址或子网掩码
Invalid IP address or subnet mask (conflicts/overlaps with another LAN bridge)=无效的IP地址或子网掩码（有其他LAN网桥相交）
Invalid IP address or subnet mask (the address of the network cannot be used)=无效的IP地址或子网掩码（不能使用的网络的地址）
Invalid IP address or subnet mask (the broadcast address cannot be used)=无效的IP地址或子网掩码（不能使用的广播地址）
invalid IP address range=IP地址范围无效
Invalid IP address range=IP地址范围无效
invalid IPv6 address=无效的IPv6地址
invalid IPv6 address range=IPv6地址范围无效
Invalid last IP address or subnet mask=结束地址或者掩码无效
Invalid length. Please enter at least=长度无效。请至少输入
Invalid length. Please reduce the length to=长度无效。请减少的长度至
Invalid MAC address=无效的MAC地址
Invalid MAC address or IP address/range=MAC地址或IP地址/范围无效
Invalid MAC or IP address=无效的MAC或IP地址
Invalid name. Only characters=名称无效。仅允许字符
invalid netmask=网络掩码无效
Invalid netmask=网络掩码无效
Invalid netmask address=网络掩码无效
Invalid number of minutes=分钟数无效
Invalid port=端口无效
Invalid port range=端口范围无效
Invalid pre-shared key. Please enter at least 8 characters or 64 hexa预共享密钥无效，请输入至少8个字符或64个十六进制数字decimal digits=预共享密钥无效，请输入至少8个字符或64个十六进制数字
Invalid range=范围无效
Invalid server address=服务器地址无效
Invalid share name. Only characters=共享名称无效，仅允许字符
Invalid SSH key=SSH密钥无效
Invalid subnet address=无效的子网地址
Invalid Subnet or IP address=无效的子网或IP地址
Invalid UNC=无效UNC
Invalid user name. Only characters=无效用户名，仅允许字符
Invalid WEP key. Expecting=无效WEP密钥，应该为
Invert Ports Order=颠倒接口顺序
IP (Hostname)=IP (主机名)
IP / MAC's non included in the list will take the Default Rate/Ceiling setting=未包含在列表中的IP/MAC地址将使用默认的速度/上限设置
IP | IP Range | MAC Address=IP | IP范围 | MAC地址
IP address=IP地址
IP Address=IP地址
IP Address / IP Range=IP地址 / IP范围
IP address outside of LAN=局域网以外的IP地址
IP Address(es)=IP地址
IP Address/Subnet=IP地址/子网
IP Traffic=IP流量
IP Traffic Daily History=IP日流量历史
IP Traffic Details=IP流量详情
IP Traffic Graphs=IP流量图表
IP Traffic is about monitoring <i>IPv4</i> network traffic flowing <i>through</i> the router=IP流量是网络<i>通过</i>路由器的<i>IPv4</i>流量监控
IP Traffic Monitoring=IP流量监控
IP Traffic monitoring disabled=IP流量监控已禁用
IP Traffic monitoring keeps track of data/packets that would be either <i>coming from/leaving</i> or <i>going to/arriving</i> IPs on LAN interfaces/subnets=IP流量监控持续跟踪LAN/子网上的IP<i>出/入</i>数据包
IP Traffic Monitoring Settings=IP流量监控设置
IP Traffic Monthly History=IP流量月历史
IP&nbsp;Range=IP&nbsp;范围
IP/Range BW Limiter=IP/范围带宽限制
IP:port=IP:port
IPP2P (disabled)=IPP2P (disabled)
IPs currently on graphic=当前显示的IP
iptraf=流量
IPTraffic=IP流量
IPv6 Configuration=IPv6配置
IPv6 Link-local Address=IPv6链路本地地址
IPv6 Port Forwarding=IPv6端口转发
IPv6 Service Type=IPv6服务类型
IPv6 support=IPv6支持
IPv6 WAN Interface=IPv6 WAN接口
is=
is not allowed=不被允许的
is not defined=没有定义
is not enabled=未启用
is now available=现在可用
is used=已被使用
is used as a root directory=被用作一个根目录
It may be also recommended to avoid using VID <b>1</b> as some vendors consider it special/reserved (for management purposes)=建议避免使用VID <b>1</b> ，因为一些厂商认为这是特殊的/保留的（出于管理目的）
It may take up to 3 minutes for the upgrade to complete. Do not interrupt the router or the browser during this time=升级可能需要3分钟才能完成。在这段时间内不要关掉路由器或浏览器
it's performance is lower than the definitive media where files will be located=它的性能取决于媒体所处的位置
Jan=一月
Japanese=日本
JFFS is not enabled=JFFS未启用
JFFS Partition=JFFS分区
JFFS Usage=JFFS使用
JFFS2 is not enabled=JFFS2未启用
Jul=七月
Jumbo Frame Size=巨帧大小
Jun=六月
kbit/s=kbit/s
Keep alive=保持活动
Keep Alive=保持活动
Keep Config Files=保存配置文件
Keep track of bandwidth usage for this IP address=跟踪这个IP地址的带宽使用情况
Key=密码
Key buffer=关键缓冲
Keys=密钥
Korean=韩国
L2TP Server=L2TP服务器
Labels on graphics=图形上的标签
LAN Access=LAN访问
LAN Access Settings=LAN访问设置
LAN Settings=LAN设置
LAN to VPN Clients=LAN到VPN客户端
LAN1=LAN2
LAN2=LAN3
LAN3=LAN4
Language=语言
last=终点
Last 24 Hours=最近24小时
Last 30 Days=最近30天
Last Access Time=上次访问时间
Last ACK=最后的ACK
Last IP Address=上次IP地址
Last Result=上次结果
Last Seen=最后上线
Last updated=最后更新
LCP Echo Interval=LCP回波间隔
LCP Echo Link fail limit=LCP回波链路失败极限
Lease=租约
Lease&nbsp;Time=租约&nbsp;时间
Leave Remote Access=离开远程访问
Leave the password field blank=请将密码字段留空
Limit=限制
Limit Connection Attempts=限制连接尝试次数
Limit PPS=限制 PPS
Limits=限制
Limits per second=每秒限制
Line=线条
Link=链接
Link With=链接至
Linux kernel=Linux内核
List only these IPs=只显示这些IP
Listen=监听
Listening GUI port=监听GUI端口
Listening port=监听端口
Load Balance Weight=负载均衡权重
Load balancing=负载均衡
loading=载入中
Loading=载入中
Local Access=本地访问
Local IP Address/Netmask=本地IP地址/掩码
Local Port=本地端口
Local/remote endpoint addresses=本地/远程端点地址
Location=位置
Log FTP requests and responses=记录FTP请求和响应
Log Info Level=日志信息级别
Log Internally=记录到内部
Log Level=日志级别
Log To Remote System=记录到远程系统
Logged Timeout=记录超时
Logging=日志
Logging Configuration=日志记录配置
Logout=登出
Logs=日志
Long=长
lost=丢失
Low=低
Lower=较低
Lowest=最低
MAC / IP Address=MAC / IP地址
MAC Address=MAC地址
MAC Address List=MAC地址列表
MAC address whitelist=MAC地址白名单
MAC Address Whitelist=MAC地址白名单
MAC addresses excluded of the feature. Leave a blank space between each MAC Address, i.e=不需要使用网页认证的MAC地址，每个MAC地址用空格分开，例如
make sure the directory exists and is writable=确保该目录存在并可写
Manage Client-Specific Options=管理客户端特定的选项
Manage MySQL via Adminer=通过管理员管理MySQL
Manual=手动
Manual Entry=手动输入
Mar=三月
Master Browser=主浏览器
Match Rule=匹配规则
max=最大
Max=最大
Max allowed packet=允许的最大数据包
Max Available Download=最大可下载量
Max Available Upload=最大可上传量
Max Bandwidth Limit=最大带宽限制
Max clients=最大客户端
Max connections=最大连接数
Max Idle Time=最大空闲时间
Max Missed ARP=最大丢失ARP
Max size before rotate=最大尺寸
Max. Perfor=最大性能
Maximum (128 bit only)=最大(128位)
Maximum 10 characters, no spaces=最多10个字符,没有空间
Maximum active DHCP leases=最大活动DHCP租借
Maximum Bandwidth for Anonymous Users=匿名用户的最大带宽
Maximum Bandwidth for Authenticated Users=认证用户的最大带宽
Maximum Clients=最大客户端
Maximum Connections= 最大连接数
Maximum Connections from the same IP=来自同一IP的最大连接数
Maximum Hops=最大跳
Maximum Receive Unit. Max packet size the PPTP interface will be able to receive without packet fragmentation=最大接收单位。最大数据包大小PPTP接口能够接收而没有包碎片
Maximum Transmission Unit. Max packet size the PPTP interface will be able to send without packet fragmentation=最大传输单位。最大数据包大小PPTP接口能够发送而没有包碎片
Maximum Users Allowed to Log in=允许登录的最大用户量
Maximum Wait Time=最大等待时间
May=五月
MD5SUM of WAN+LAN MAC addresses=WAN +LAN的MAC地址的MD5SUM
Measure=测量
Measuring Noise=测量噪声
Measuring radio noise floor=测量无线本底噪音
Media / DLNA Server=媒体 / DLNA服务器
Media Directories=媒体目录
Media scan may take considerable time to complete=媒体扫描可能需要相当长的时间才能完成
Media Server=媒体服务器
Medium=中
Memory Usage=内存使用率
Message level=消息级别
Messages from this module stored internally for better trace. Level=为了更好的跟踪，从这个模块的消息会在内部存储，级别
messages per minute / 0 for unlimited=每分钟的消息 / 0代表无限制
meters=米
MHz=MHz
min=最小
Min=最小
Min.Perfor=最小性能
Miniupnpd=Miniupnpd
mins=分钟
minute=分钟
minute window=分钟窗口
minutes=分钟
Miscellaneous=其他
Miscellaneous Settings=其它设置
mix=混合
Mixed Mode=混合模式
Mode=模式
Model=型号
Model of router. Ex=路由器的型号。例如
Modem device=调制解调器设备
Modem init string=调制解调器的初始化字符串
Mon=周一
Monday=周一
Monitor=监控
Monitor Web Usage=监控网络使用
Monitoring of larger subnets is not supported=不支持较大的子网监控
Monthly=每月
Monthly Bandwidth=每月带宽
Monthly History=月历史
Monthly IP Traffic=每月IP流量
Mount=挂载
Mount all Partitions of Storage Device=挂载存储设备的所有分区
mounted=已挂载
mounted on=挂载在
Mounted?=已挂载？
Move=移动
Move Down=下移
Move Up=上移
Multicast=组播
Multicast Rate=组播速度
Multiple LAN support integration and GUI=多LAN支持集成和GUI
Multiple/virtual SSID support (experimental)=多个/虚拟SSID支持（可选）
MultiWAN Routing=MultiWAN路由
must=必须
Must also be defined in the=必须定义在
Must also be defined in the Hosts area=必须被定义在Hosts范围内
must be a multiple of 16=必须是16的倍数
must be defined in the hosts area when Start With WAN is checked=必须被定义在hosts范围内当“同WAN一起启动”勾选的时候
must be in different subnet to router=必须在路由的不同子网中
must be supported by the upstream nameservers=必须由上游的域名服务器支持
must be uploaded to the device?=必须上传到设备
must configure manually=必须手动配置
Must resolve to the external IP address where the host can be reached=必须解决主机可以达到外部的IP地址
Mute dhcpv4 logging=Mute dhcpv4记录
Mute dhcpv6 logging=Mute dhcpv6记录
Mute RA logging=Mute RA记录
MutliWAN feature=MutliWAN功能
MySQL binary path=MySQL二进制文件路径
MySQL Database Server=MySQL数据库服务器
MySQL listen port=MySQL监听端口
MySQL Server=MySQL服务
MySQL server custom config.=MySQL服务器自定义配置
MySQL Server custom config.=MySQL服务器自定义配置
MySQL Server integration and GUI=MySQL服务集成和GUI
N Only=仅N
Name=名称
Name of the host. There must be an entry for this host=主机名称。必须要有这个主机的条目
Name that will appear on top of your Internet Browser=名字将出现在你的网络浏览器上
NAT loopback=NAT回流
NAT target=NAT目标
Native IPv6 from ISP=自ISP的原生IPv6
NAT-PMP or UPnP must be enabled in least one LAN bridge. You may continue but remember to configure an access to UPnP service by Custom Configuration=NAT-PMP或UPnP必须在至少一个局域网桥上启用。你可以继续下去,但记得要配置一个访问UPnP的自定义配置
NAT-PMP or UPnP should be enabled in least one LAN bridge. You may continue but remember to configure an access to UPnP service by Custom Configuration=NAT-PMP或UPnP应该在至少一个局域网桥上启用。你可以继续下去,但记得要配置一个访问UPnP的自定义配置
Navigation Menu=导航菜单
Netbios Name=Netbios名称
Netmask=掩码
Netmask should have at least 22 bits=掩码应该至少有22位
Netmask should have at least 22 bits (255.255.252.0). You may continue anyway but remember - you was warned=掩码应该至少有22位（255.255.252.0）。您可能仍然继续，但请记住 - 你被警告
Network=网络
Network address assigned to this device on the local network=在本地网络上分配给这个设备的网络地址
Network Congestion Control=网络拥塞控制
Network traffic/communications flowing from/to/between different LAN bridges/subnets will be tracked/accounted separately/accordingly=不同的LAN网桥之间的网络流量/通信将被分别跟踪/核算
Network Type=网络类型
Never=从不
Never select a lower value than the kernel uses. Do not use the service test page to adjust the server performance=永远选择低于内核使用的值。不要使用服务测试页面来调整服务性能
NEW=新建
New Rule=新规则
NFS Client=NFS客户端
NFS Server=NFS服务器
NFS utils integration and GUI=NFS卷集成和GUI
NGINX Custom Configuration=NGINX自定义配置
NGINX HTTP Section Custom Configuration=NGINX HTTP章节自定义配置
NGINX is currently=NGINX当前
NGINX SERVER Section Custom Configuration=NGINX 服务章节自定义配置
NGINX Web Server=NGINX Web 服务器
No=否
No ACK=无ACK
no cookie found=未发现Cookie
no data=空
No Ingress QOS for UDP=No Ingress QOS for UDP
no limit=无限制
No Limit=无限制
No MAC or IP address was specified=没有MAC或IP地址被指定
No NTLM=无NTLM
no timeout=无超时
No, i definitely wont enable it=不，我绝不会启用它
No, i don`t. Have to read all information, before i will make a choice=不，我不知道。在我作出选择前我必须要阅读所有的信息
Nobody=无用户
Nodes=节点
Noise=噪声
Noise Floor=本底噪声
nolimit=无限制
none=无
None=无
N-only is not supported in wireless client modes, use Auto=“仅N”方式不支持无限客户端模式，请用“自动"方式
Non-WLAN=非WLAN
Normal=标准
Normal Access Restriction=普通访问限制
North America=北美
not=非
Not all models support these options=不是所有型号支持这些选项
not allowed=不允许
not allowed NULL=不允许空
Not Available=不可用
Not considered when calculating total traffic on the last line=最后一行计算总流量时不考虑
Not include=不包含
not mounted=未挂载
not your username=不是你的用户名
Note=注释
note: enable if this is a new file=注意：如果是新文件请启用
Note: If Login Time is expired you should re-enter again into the splash page to get a new lease period. Be aware, there is no notice about expired period so, you can loss Internet Access=注释：如果登录时间超时你必须重新进入启动页面去获取一个新的租借时间，请明确这个超时时间不会提醒您，届时你会无法因特网访问
note: you might wish to cross-check settings later on=注意：您可能希望稍后再确认设置在
Notes=注释
Nov=十一月
Now=现在
NTFS Driver=NTFS驱动
NTLM and packet signing=NTLM和数据包签名
NTLMv2=NTLMv2
NTLMv2 and packet signing=NTLMv2和数据包签名
NTP=NTP
NTP Time Server=NTP时间服务器
Number of Entries to remember=记住条目的数量
Number of lost ARP before considering the client has leaved the connection. Default=在认为客户端断开连接之前丢失的ARP量，默认
Number of rotated logs to keep=日志保存的数量
Number of WAN Ports=WAN口数量
NVRAM Commit=NVRAM提交
NVRAM Usage=NVRAM使用率
Oceania=大洋洲
Oct=十月
of any physical wireless interfaces shouldn't be touched here=任何物理无线接口不应该接触
off=关闭
Off=关闭
Offline=离线
on=在
On=开启
on devices with multiple VIF capabilities=设备上具有多个VIF的能力
One and only one VID can be used for=只允许一个VID作为
one port=一个端口
One VID=一个VID
One VID <i>must</i> be assigned to WAN=一个VID <i>必须</i> 分配到WAN
One VID <i>must</i> be selected as the default=一个VID <i>必须</i> 选为默认值
On-line from TTB=在线获取
Online Since=在线自动
Only 10 ports/range sets are allowed=只允许设置10个端口/端口范围
Only at startup=仅启动时
Only connections to destination port 80 are redirected to TOR=只有到目的端口80的连接被重定向到TOR
Only meaningful for K24 builds=只对K24 builds有意义
Only one port per entry is supported when forwarding to a different internal port=当转发到一个不同的内部端口时，每个条目只支持一个端口
Only one untagged VLAN per port is allowed (Native VLAN)=每个端口只有一个未标记的VLAN允许（原生VLAN）
Only one VID can be selected as the default VID=只允许设置一个默认的VID
Only one VID can be used as=只允许设置一个VID作为
Only one wireless interface can be configured in client mode=仅一个无线接口可配置成客户端模式
Only required to create legacy connections with tinc1.0 nodes=只需要创建与tinc1.0节点兼容的连接
Only these IPs=仅这些IP
Open HFS/HFS+ driver=Open HFS/HFS+驱动
Open Menus=展开菜单
Open NTFS-3G driver=Open NTFS-3G驱动
Opens access to ports on machines inside the LAN, but does=开放对局域网内机器的端口访问，但是
OpenVPN Client=OpenVPN客户端
OpenVPN Client Configuration=OpenVPN客户端设置
OpenVPN enhancements &amp; username/password only authentication=OpenVPN增强&用户名/密码验证
OpenVPN integration and GUI=OpenVPN集成和GUI
OpenVPN Server=OpenVPN服务器
OpenVPN Server Configuration=OpenVPN服务器设置
Openvpn username/password verify feature and configure GUI=Openvpn用户名/密码验证功能和GUI配置
option here. If incomplete dir is enabled, all incomplete files will be downloaded to=在此选择，如果启用了不完整的目录，所有未完成的文件将被下载到
option here. Whitelist is always disabled=在此选择。白名单总是不可用
option here. You can set it in Tomato GUI=在此选择。您可以在Tomato GUI设置它
optional=可选项
optional; ex=可选项；例如
Options=选项
or=或
or Firefox for any system, or Safari. Other=或火狐浏览器，或者Safari。其他
or invalid domain name=或域名无效
Orange=橙色
Orange Color Scheme=橙色配色方案
Other (Manual Configuration)=其他（手动配置）
Other ISP Config=其他ISP设置
Other Options=其他选项
Other relevant notes/hints=其他相关注释/提示
Other Timeouts=其他超时
OUI search=OUI搜索
OUI Search=OUI搜索
out of=出自
Outbound=出站
Outbound Direction=出站方向
Outbound Rates / Limits=出站速度 / 限制
Outgoing=流出
Overlapping BSS Coexistence=重叠的BSS共存
Overview=概览
Packet Size=数据包大小
Packets=数据包
page=页面
page instead)=页面代替）
page, others won't be able to obtain an IP address through DHCP=页面，其它无法通过DHCP获得IP地址的MAC地址
Paragon driver=Paragon驱动
Parrot=应答
Partition=分区
passed to clientSideInclude=传递到clientSideInclude
Passphrase=密码
Password=密码
Password can not be NULL value=密码不能为空
password cannot contain=密码不能包含
password is mandatory=密码是必须的
Password must not be empty=密码不能为空
Path to the directory containing mysqld etc. Not include program name=路径目录包含mysqld等。但是不包括程序名
Path to the directory containing transmission-daemon etc=包含transmission-daemon的路径目录等
Peer limit per torrent=每种子节点数限制
Permit only the following clients=允许以下客户端
PHP Custom Configuration=PHP自定义设置
PIN Code=PIN码
Ping Count=Ping计数
Please=请
Please be sure of your decision before change this settings=确定要改变设置吗
Please configure=请设置
Please do not remove or change the homepage link or donate button=请不要删除或更改主页链接或捐赠按钮
Please enter a specific address or port, or select an application match=请输入一个特定的地址或端口，或选择一个应用程序匹配
Please enter one domain per line=请每行输入一个域名
Please Follow these Instructions to get it corrected=请按照提示进行修复
Please go to=请前往
Please specify what items should be blocked=请指定应阻止哪些项目
Please start at the / root directory=请在/ root目录开始
Please wait=请稍候
Please Wait=请稍候
Please wait for=请等待
Please wait while new firmware is being uploaded and flashed=新固件正在上传并更新，请等待
Please wait while the defaults are restored=正在恢复出厂设置，请等待
Please wait while the firmware is uploaded &amp; flashed=固件正在更新，请等待
Please wait while the router restarts=请等待路由器重新启动
Please wait while the router shuts down=请等待路由器关机
Policy routing traffic only work on the LAN to the Internet=策略路由流量仅工作在局域网到互联网上
Poll Interval=轮询间隔
Port=端口
Port / Application=端口 / 应用程序
Port Forwarding=端口转发
Port Numbers on Router Case (Left -> Right viewed from Front)=路由器上的端口号（从正面看左->右）
Port to be used by the Captive Portal for page redirection. Port 1 to 65534. Default=网页认证为页面重定向而使用的端口，端口1至65534，默认
Port used for torrent client. Make sure this port is not in use=torrent客户端使用的端口。请确保没有被使用
Port used for Transmission GUI. Make sure this port is not in use=Transmission GUI使用的端口。请确保没有被使用
Ports=端口
PPTP Client=PPTP客户端
PPTP Client Configuration=PPTP客户端设置
PPTP Gateway=PPTP网关
PPTP Online=PPTP在线
PPTP Server=PPTP服务器
PPTP Server Configuration=PPTP服务器设置
PPTP Server integration and GUI=PPTP服务支持和GUI
PPTP User List=PPTP用户列表
PPTP Users Online=PPTP用户在线
PPTP VPN Client integration and GUI=PPTP VPN客户端集成和GUI
Preamble=报头
Preemption=取代
Prefer to show only known hostnames, otherwise show IPs=倾向于只显示主机名,否则显示IP
Prefix Length=前缀长度
Prevent DNS-rebind attacks=防止DNS-rebind攻击
primary VIF=主VIF
Prioritize ICMP=优先ICMP
Prioritize small packets with these control flags=优先这些控制标志的小数据包
Priority=优先级
Priority Class=优先级类
Private=私有
Private Root Directory=私有根目录
Proto=协议
Protocol=协议
Provider Name=服务商名称
Public Root Directory=公共根目录
Push=推送
Push LAN to clients=推送LAN至客户端
Qdisc Scheduler=队列规则调度
QoS=QoS限速
QoS BW Limiter=Qos带宽限制
QOS Class Names=QOS分类名称
QOS Classification Rules=QOS分类规则
QOS Details=QoS 详情
QoS disabled=QoS不可用
QoS is disabled=Qos已关闭
QOS Transfer Rates=QOS传输速率
QOS-detailed & ctrate filters=QOS详情 & 创建过滤
qosdetails=Qos详情
qosrates=Qos速率
Quality=质量
Quality (%)=质量(%)
Quality of Service=Qos设置
Query cache size=查询缓存大小
Queue torrents=种子队列
Quick Start-Stop Service. Enable Web Server must be checked to modify settings=快速启用-停止服务。启用Web服务前必须检查修改的设置
Radio=无线
Radio Band=无线波段
Radius=Radius
Radius Server=Radius服务器
RAM (Temporary)=RAM（临时）
RAM Temporary=临时RAM
Random=随机
range=范围
Range=范围
range of ports=端口范围
Rate=速率
Rates=速度
Read / Write=读/写
Read buffer size=读取缓冲区大小
Read only=只读
Read Only=只读
Read rand buffer size=读取边缘缓冲区大小
Read/Write=读/写
Real Time Bandwidth=实时带宽
Real Time IP Traffic=实时IP流量
Real-Time=实时
Real-Time Bandwidth=实时带宽
Realtime bandwidth monitoring of LAN clients=LAN客户端实时带宽监控
Real-Time Client Monitor=实时客户端监控
Reboot=重启
Reboot?=重启？
Rebooting=重新启动中
Rebooting, please wait=重新启动中，请稍等
Receive Antenna=接收天线
received=已接收
Recent Web Searches=最近的网页搜索
Recently Visited Web Sites=最近访问的Web站点
recommended=推荐
Reconnect=重连
recreated=重新创建
recreated=重新创建
Red=红色
Red Color Scheme=红色配色方案
Redesigned AT interface=重新设计的 AT 界面
Redial Interval=重拨间隔
Redirect all users from=重定向所有用户自
redirect Internet traffic=重定向Internet流量
Redirect Internet traffic=重定向Internet流量
Redirect remote access ports for SSH and HTTP(s) to router=为SSH和HTTP(s)远程访问路由器重定向端口
Redirect TCP Ports=重定向TCP端口
Redirect through VPN=通过VPN重定向
redirections=重定向
Reduce packet size=减小的数据包
re-enter to confirm=重新输入以确认
Refresh=刷新
Refresh Status=刷新状态
Refreshing=刷新中
Regenerate=重新生成
Regulatory Mode=监管模式
Re-init priv. table=初始化priv.表
Re-init root password=初始化root密码
Relay Anycast Address=转发选播地址
Release=释放
Reload Information=重新加载信息
Remaining Lease Time=剩余租约时间
re-map ports=重映射端口
Remote access=远程访问
Remote Access=远程访问
Remote Forwarding=远程转发
Remote IP Address Range=远程IP地址范围
Remote IP addresses to be used on the tunnelled PPP links (max 6)=用于PPP链接隧道的远程IP地址(最大数 6)
Remote Port=远程端口
Remote subnet / netmask=远程子网/掩码
removed=已删除
Renew=更新
Repeat Password=重新输入密码
Request /64 subnet for=要求 / 64 子网为
request per second=次请求每秒
Required (128 or 40 bit)=需求(128或40 位)
Rescan on the next run=下次运行时重新扫描
Reset class when changing settings=更改设置时重置分类
Reset Data=重置数据
resolve=解析
Resolve the hostname of this address=解析这个地址的主机名
Resolver=解决方案
Resolver Details=解决方案详情
Respond to DNS=响应DNS
Respond to ICMP ping=响应ICMP Ping
Restart=重启
Restarting=重新启动中
Restore=恢复
Restore Configuration=恢复设置
Restore data from=恢复数据从
Restore Default Configuration=恢复默认设置
Restore default router settings (normal)=恢复路由器默认设置
Restore defaults=恢复默认值
Restoring Defaults=正在恢复默认值
Restriction=限制
Results from=结果自
reverse=反转
Revised IP/MAC Bandwidth Limiter=修订IP / MAC带宽限速
Revised Multi-Language support=修订多语言支持
RO Community=RO Community
Root=Root账户
Root Directory=根目录
root password=root密码
root user name=root用户名
Round-Trip=往返
Route Modem IP=路由调制解调器IP
Router=路由器
Router Configuration=路由器配置
Router Identification=路由器名称
Router Info=路由器信息
Router IP Address=路由器IP地址
Router IP Addresses=路由器IP地址
Router IPv6 Address=路由器IPv6地址
Router Logging=路由器日志
Router Logs=路由器日志
Router MAC Address=路由器MAC地址
router may be harmful. It may not be able to re-setup the NVRAM correctly after a complete erase. Proceeed anyway?=可能会对路由器造成损害，完全擦除NVRAM可能造成其再被无法正确设置，继续吗
Router must be rebooted to proceed. Commit changes to NVRAM and reboot now?=必须重新启动路由器进行，提交改变至NVRAM，并立即重新启动
Router Name=路由器名称
Router Scripts=路由器脚本
Router Time=路由器时间
Router Upgrade=路由器升级
Router's LAN MAC Address=路由器LAN的MAC地址
Routes must be configured manually=必须手动配置路由
Routing=路由
Routing Policy=路由策略
Routing Table=路由表
RSA Private Key=RSA私钥
RSA Public Key=RSA公钥
RTS Threshold=RTS阈值
Rule=规则
Rules=规则
Run after mounting=挂载后执行
Run As=运行使用
Run before unmounting=卸载之前运行
Run Custom Script=运行自定义脚本
running=运行中
Running=正在运行
Russian=俄语
RX=接收
RX Bytes=接收字节
S Port=源端口
Safely Remove Storage Device=安全删除存储设备
Samba File Sharing=Samba文件共享
Same as normal lease time=与普通租约时间相同
same as used in QoS=与在QoS中使用的相同
Sat=周六
Saturday=周六
Save=保存
Save Frequency=保存频率
Save History Location=历史记录保存位置
Save In NVRAM=保存到NVRAM
Save On Shutdown=关机时保存
Save settings location=设置保存位置
Save state when IP changes=IP变化时保存状态
Save state when IP changes (nvram commit)=IP变化时保存状态 (nvram commit)
Saved=已保存
Saving=保存中
Scale=单位
Scan=扫描
Scan Media at Startup=在启动时扫描媒体
scanning=搜索中
Schedule=时间表
Scheduler=任务计划
Script is fully open, and written in bash. Anyone is free to look at the content that is submitted to the database=脚本是完全开放的,并且是用bash编写的。任何人都能免费查看提交到数据库的内容
script is too long. Maximum allowed is=脚本过长，最大允许长度是
Scripts=脚本
SD/MMC Card Support=SD/MMC卡支持
SDHC / MMC=SDHC / MMC
SDHC integration and GUI=SDHC集成及GUI
SD-idle tool integration for kernel 2.6=为2.6内核集成SD-idle工具
Search Criteria=搜索条件
Search through available log files for specific text and display matched rows=搜索可用日志文件查找特定文本并显示匹配行
Search Time=搜索时间
Searches=搜索
sec.(1 Hour)=秒.（1小时）
second=秒
second interval=秒间隔
seconds=秒
Seconds=秒
seconds per hop=每跳秒数
Secret=加密
Secure Mode=安全模式
Security=安全
see=查看
See also the=查看
Seeds queuing=播种队列
Select=选择
Select Cancel=选择“取消”
Select new image=选择固件
Select one of the bridges on which Captive Portal will listen=选择一个需要网页认证的网桥
Select the configuration file to restore=选择设置文件用以恢复
Select the file to use=选择要使用的文件
Select user used to start nginx and php-cgi daemon=选择用户用于启动nginx和php-cgi守护进程
Selected IP`s=已选的IP
Selected Ports=已选的端口
Sep=九月
Seq=序号
Serial No=序列号
Server=服务器
Server Address=服务器地址
Server Address/Port=服务器地址/端口
Server Certificate=服务器证书
Server is not running or status could not be read=服务器没有运行或无法读取的状态
Server is on the same subnet=服务器在同一子网
Server Key=服务器密钥
Server Priority=服务优先级
Server Root Path=服务器根目录
SERVER Section=服务章节
Service=服务
Service Name=服务名称
SES/WPS/AOSS Button=SES/WPS/AOSS按钮
set=设置
set to 0 to disable=设置0为禁用
set to '0' to use 'regular' VLAN/VID mappings instead=设置为“0”来代替使用“常规”的VLAN / VID映射
Sets the service priority over other processes running on the router=设置服务优先于运行在路由器上的其他进程
setting=设置
Settings=设置
Settings for DSL only=仅用于设置DSL
settings page for more DHCP-related configuration options=设置页面关于DHCP的更多配置选项
Settings saved. Some services are being restarted...=设置已保存，服务正在重启中...
Severe=严重
Share Name=共享名称
Shared Key=共享密钥
Short=短
show=显示
Show=显示
Show hostnames=显示主机名
Show In My Network Places=在“网上邻居”中显示
Show known hostnames=显示已知的主机名
Show known hostnames and IPs=显示已知的主机名和IP
Show only IPs=只显示IP
Show only these IPs=只显示这些IP
Show shortcuts=显示快捷键
Show Speed Info=显示速率信息
Show subnet totals=显示子网总数
Show up to=最多显示
showing=显示
Shutdown=关机
Shutdown?=关机？
Shutting down=正在关机
Signal Quality=信号质量
Silent=安静
Simplified Chinese=简体中文
Single Line MLPPP=单线MLPPP
SNMP=SNMP
SNMP integration and GUI=SNMP + GUI
SNMP Settings=SNMP设置
so that previously defined/saved settings might need to be updated/changed accordingly on=所以之前定义/保存的设置可能需要相应地更新/改变在
Socks Port=Socks端口
Solid=纯色
some of the changes will take effect after a restart=一些改动将会在重启后生效
Some of the changes will take effect only after a restart=一些改动将会在重启后生效
Sorry, your browser does not support=对不起，你的浏览器不支持
Sort buffer size=排序缓冲区大小
Source=源地址
Source Address=源地址
Source address allowed. Ex=允许的源地址，例如
Source Address Restrictiones=源地址限制
Source and Destination interfaces must be different=源和目标的接口必须是不同的的
Source IP Address=IP源地址
Source LAN bridge=LAN源网桥
South America=南美洲
space=空格
space separated=用空格分隔
Spanning-Tree Protocol=生成树协议(STP)
Special Thanks=特别感谢
Spin down each HDD when idle. No need to use with flashdrive=当硬盘空闲时降速，对于闪存无需使用此选项
Src=源
Src Address=源地址
Src IP=源IP
Src MAC=源MAC
Src or Dst=源或目标
src port=源端口
Src Port=源端口
SSH Daemon=SSH访问设置
SSID=SSID
SSL Certificate=SSL证书
Start=开始
start cmd.exe and type chcp to see the current code page=运行cmd.exe然后输入chcp以查看当前代码页
Start now=现在启动
Start PPTP Client=启动PPTP客户端
Start VPN Client=启动VPN客户端
Start VPN Server=启动VPN服务器
Start with WAN=同WAN一起启动
Start With WAN=同WAN一起启动
Startup LED=启动LED
Stateless MPPE connection=无状态MPPE连接
Static=静态
Static ARP binding=静态ARP绑定
Static DHCP/ARP=静态DHCP/ARP
Static DHCP/ARP & Bandwidth Monitoring of LAN Clients=静态DHCP/ARP & LAN客户端带宽监控
Static DHCP/ARP/BW=静态DHCP/ARP/BW
Static DHCP/ARP/IPT=静态 DHCP/ARP/IPT
Static DNS=静态DNS
Static IP=静态IP
Static Key=静态密钥
Static Lease=静态租约
Static lease time=静态租约时间
Static Routing Table=静态路由表
Status=状态
Status Button=状态按钮
Status Overview=概况
Stop=停止
Stop now=现在停止
Stop PPTP Client=停止PPTP客户端
Stop seeding at ratio=停止播种在此
Stop seeding if idle for=如果空闲停止播种
Stop VPN Client=停止VPN客户端
Stop VPN Server=停止VPN服务器
stopped=已停止
Stopped=已停止
Strictly adhere to DLNA standards=严格依照DLNA标准
Strict-Order=严格排序
strongest=最强
Subnet=子网
Subnet is left blank when using the TAP Interface Type=当使用TAP接口类型时子网是留空的
Subnet Mask=子网掩码
subnet-down=子网取消
subnets=子网
Subnets=子网
subnet-up=子网建立
Subtree Check=子树检查
Summary=摘要
Sun=周日
Sunday=周日
swap=SWAP
SWAP Usage=SWAP使用率
SYN Received=接收SYN
SYN Sent=发送SYN
Sync=同步
Syslog=系统日志
System=系统
System Commands=系统命令
Table open cache=表打开时的缓存
table.=表
Tagged=已标记
Target=目标
TCP Connections=TCP连接数
TCP IN/OUT (pkt/s)=TCP 进/出 (pkt/s)
TCP Limit=TCP限制
TCP Timeout=TCP超时
TCP Vegas=TCP Vegas
TCP/UDP=TCP/UDP
Telnet Daemon=Telnet访问设置
Temperature=温度
Temporary=临时的
Thank you for reading and please make the right choice to help this project=感谢你的阅读，请做一个正确的选择来帮助这个项目
Thanks=谢谢
Thanks to everyone who risked their routers, tested, reported bugs, made suggestions and contributed to this project=感谢所有冒着风险测试路由器,报告bug,提交建议和为这个项目做贡献的人
That`s it=就是这样
the address of the network cannot be used=网络地址不能使用
The bandwidth will be shared by all hosts in=所有主机将共享带宽在
The bandwidth will be shared by all hosts in br1=br1上的所有主机将共享带宽
The bandwidth will be shared by all hosts in br2=br2上的所有主机将共享带宽
The bandwidth will be shared by all hosts in br3=br3上的所有主机将共享带宽
The bandwidth will be shared by all unlisted hosts in br0=br0未列出的所有主机将共享带宽
the broadcast address cannot be used=广播地址不能使用
The contents of file /etc/dnsmasq.custom are also added to the end of Dnsmasq's configuration file (if it exists)=/etc/dnsmasq.的文件内容也会添加到Dnsmasq配置文件的结尾(如果存在的话)
The cstats program is not responding or is busy. Try reloading after a few seconds=此cstats程序没有响应或正忙，请几秒钟后重新加载
The default settings are indicated with an asterisk=默认设置是用星号表示
The destination address inside the LAN=局域网内的目标地址
The destination port inside the LAN. If blank, the destination port is the same as=局域网内的目标端口，如果为空，目的端口则相同与
The device is busy. Please make sure no applications are using it, and try again.=设备正忙，请确保没有任何应用程序正在使用它，然后再试一次
The Following=以下
The following data is sent by TomatoAnon=下面的信息是TomatoAnon将要发送的
the following day=以下日期
The following NTP servers have been automatically blocked by request from the server=以下的NTP服务器已自动被从服务器的请求阻止
The information submitted is 100% anonymous and will ONLY be used for statistical purposes=提交的信息是100%匿名的,将只用于统计目的
The IP Range devices will share the Bandwidth=IP范围内的设备共享带宽
The level of compression used for UDP packets. Possible values are=用于UDP数据包的压缩级别。值可能是
The local http/https must also be enabled when using remote access=当使用远程访问的时候，必须启用http/https服务
The location where the Welcome banner is located=欢迎横幅的位置
The name of the Gateway appearing in the welcome banner=在出现的欢迎横幅的网关的名称
The netmask for the entire VPN network=整个VPN网络的子网掩码
The NVRAM Dump text file may contain information like wireless encryption keys and usernames/passwords for the router, ISP and DDNS. Please review &amp; edit this file before sharing it with anyone=NVRAM转储文件可能包含路由器的无线加密密钥，以及路由器、ISP、DDNS的用户名、密码等信息。与其他人共享此文件之前，请查看并修改它们
The NVRAM free space is very low. It is strongly recommended to=NVRAM空闲空间低，强烈建议
The operating system kernel has priority=操作系统内核的优先级
The path in your router where documents are stored=在你服务器上存储文档的路径
The port the host listens on. If empty the default value (655) is used=主机监听的端口。如果空则使用默认值(655)
The Port used by the Web Server to be accessed. Check conflict when the port is used by other services=访问Web服务使用的端口。检查是否与其他服务的端口冲突
The ports to be forwarded, as seen from the WAN. Ex=自广域网得到的需要转发的端口。例如
The ports to be opened for forwarding. Ex=转发需要打开的端口，例如
The router will reset its address back to 192.168.1.1=路由器将复位其地址到192.168.1.1
The router will reset its address back to 192.168.1.1. You may need to renew your computer's DHCP or reboot your computer before continuing=路由器将复位其地址到192.168.1.1您可能需要更新您的计算机的DHCP或重新启动计算机，然后再继续操作
The router's new IP address is=路由器的新IP地址是
The rstats program is not responding or is busy. Try reloading after a few seconds=此rstats程序没有响应或正忙，请几秒钟后重新加载
The submitted results can be viewed on the=提交的结果可以查看在
The subnet which the host will serve=服务器主机所在的子网
the tag contains only user priority information=标签只包含用户优先级的信息
The TomatoAnon script will send (to a database) information about your router's model and installed version of Tomato=TomatoAnon脚本将发送路由器的型号和Tomato的版本信息(到一个数据库)
The URL that will appear after you Agree the Welcome Banner=当你同意欢迎横幅后将要出现的URL
Theme name from=获取主题从
There has been many reports how AdvancedTomato did not flash well or it came with many bugs. Reason for that is bad image files which can sometimes get corupted at the download process.=已有很多关于 AdvancedTomato 不能完好的刷写或者出现许多问题的报告。原因可能是下载过程中出现问题导致固件损坏，
There is no upload status information in this page and there will be no change in the display after the Upgrade button is pushed. You will be shown a new page only after the upgrade completes=在这个页面没有上传状态信息并且点击升级按钮后显示不会改变。当升级完成后你需要打开一个新页面
These issues usually occur when file is missing or router is unavailable to accept new connections=这些问题通常发生在文件丢失或路由器无法接受新连接的时候
These ports are automatically closed after a few minutes of inactivity=这些端口会在几分钟的闲置后自动关闭
This feature is not supported on this router=路由器不支持此功能
This information may help you when choosing the best and most popular router available in your country=这些信息可以帮助你选择在你国家最好和最受欢迎的路由器
This message is here to warn you to check MD5 checksum=这个消息是在这里提醒你检查MD5校验
This option allows you to add custom navigation links or rewrite existing ones. Only JSON format accepted=此选项允许您添加自定义导航链接或重写现有的链接。只接受JSON格式
This option will open the Transmission GUI port from the WAN side and allow the GUI to be accessed from the internet=这个选项将从广域网打开Transmission GUI端口并允许从互联网访问图形化界面
This option will open the Web Server GUI port from the WAN side. Service will be accessed from the internet=这个选项将打开从广域网端口访问Web服务器的GUI。服务将从互联网被访问
This rule is too big. Please reduce by=此规则是太大了，请减小
This script does NOT send any private or personal information whatsoever (like MAC`s, IP`s etc)=这个脚本不会发送任何私人或个人信息(如MAC、IP等)
This service determines the IP address using its own method=此服务使用它自己的方法确定的IP地址
This web interface allows configuring a maximum of 4 VIFs for each physical wireless interface available=这个web接口允许为每个物理无线接口配置最多4个VIF
This web interface allows configuring a maximum of 4 VIFs for each physical wireless interface available - up to 3 extra VIFs can be defined in addition to the primary VIF (<i>on devices with multiple VIF capabilities</i>)=这个web接口允许为每个物理无线接口配置最多4个VIF，在主VIF以外可以配置高达3个额外的VIF (<i>在支持多 VIF的设备上</i>)
this will identify a router. Ex=这将用于确定一个路由器。例如
Thread cache size=线程缓存大小
Thread stack=线程栈
Thu=周四
Thursday=周四
Time=时间
Time Wait=等待时间
Time Zone=时区
Tinc Configuration=Tinc配置
Tinc Daemon=TINC守护
Tinc Daemon integration and GUI=Tinc守护程序集成和GUI
Tinc is currently=Tinc当前
Tinc Mesh VPN=Tinc Mesh VPN
Tinc will try to establish a meta-connection to the host. Requires the Address field=Tinc将尝试建立一个到主机的meta-connection。地址字段是必须的
tinc-down=tinc关闭
tinc-up=tinc启动
tinc-up creation=tinc启动建立方式
TiVo Support=TiVo支持
TKIP encryption is not supported with WPA / WPA2 in N and AC mode=WPA / WPA2在N和AC模式下不支持TKIP加密
TKIP encryption is not supported with WPA / WPA2 in N mode=WPA / WPA2在N模式下不支持TKIP加密
TLS Renegotiation Time=TLS重新协商时间
Tmp dir.=临时目录
to=到
To=到
To clear the credentials cached by the browser=要清除浏览器缓存的凭据
To Destination IP=到目标IP
to disable=禁用
To Domain=到域名
To enable/enforce static ARP binding for a particular device, it must have only one MAC associated with that particular IP address (i.e. you can't have two MAC addresses linked to the same hostname/device in the table above)=为特定设备使用/执行静态ARP绑定，MAC地址只能与一个特定的IP相关联（即：在上面的表中你不能有两个MAC地址绑定到同一台的主机/设备）
To prevent 802.1Q compatibility issues, avoid using VID <b>0</b> as 802.1Q specifies that frames with a tag of <b>0</b> do not belong to any VLAN=为了防止802.1q的兼容性问题，避免使用VID
To specify multiple hostnames for a device, separate them with spaces=指定一个设备的多个主机名,用空格隔开
Toggle Collapsed Navigation=切换折叠导航
Toggle Visibility=切换显示
Toggle Wireless=无线开关
Tomato Update Notification System=Tomato升级通知系统
TomatoAnon configuration page=TomatoAnon项目配置页面
TomatoAnon Project=TomatoAnon项目
TomatoAnon project integration and GUI=TomatoAnon项目集成和GUI
TomatoAnon Settings=TomatoAnon设置
Tomato-ARM Team=Tomato-ARM团队
TomatoThemeBase project integration and GUI=TomatoThemeBase项目集成和GUI
TomatoUSB Team=TomatoUSB团队
Too many addresses=地址过多
Too many hostnames=主机名过多
Too many IP addresses=IP地址过多
Tools=工具
Tools - System refresh timer=工具-系统定时刷新
TOR Project=TOR项目
Tor Project=TOR项目
TOR Project integration and GUI=TOR项目集成和GUI
Tor Project Settings=TOR项目设置
Torquoise Color Scheme=绿松石配色方案
total=总计
Total=总计
Total / Free Memory=总计 / 空闲内存
Total / Free NVRAM=总计 / 空闲NVRAM
Total / Free Size=总计 / 空闲空间
Total / Free Swap=总计 / 空闲Swap
Trace=Trace跟踪
Trace Route=路由跟踪
Traceroute=路由跟踪
Tracking / NAT Helpers=跟踪 / NAT助手
Traditional Chinese / Big=繁体中文
Trans Port=传输端口
Transfer Rates=传输速率
Transferred=已传输
Transmission 2.92 integration=Transmission 2.92
Transmission binary path=Transmission执行文件的路径
Transmission Rate=Transmission 速率
Transmit Antenna=发射天线
Transmit Power=发射功率
transmitted=已传输
Trigger Connect On Demand=触发按需连接时
Trigger Ports=触发端口
Trigger Ports are the initial LAN to WAN 'trigger'=触发端口是最初从局域网到广域网的“触发”
Triggered=触发
Triggered Forwarding=触发转发
Triggered Port Forwarding=触发端口转发
Try to avoid any conflicts and/or overlaps between the address ranges configured/available for DHCP and VPN clients on your local networks=尽量避免在本地网络的DHCP和VPN客户端的地址范围之间的任何冲突或重叠配置
TTB ID=TTB ID
TTL Adjust=TTL校准
Tue=周二
Tuesday=周二
Tunnel address/netmask=隧道地址/掩码
Tunnel Client IPv6 Address=隧道客户端的IPv6地址
Tunnel MTU=隧道MTU
Tunnel Remote Endpoint (IPv4 Address)=隧道远程端点（IPv4地址）
Tunnel TTL=隧道TTL
Turns on broadcast relay between VPN clients and LAN interface=打开广播中继VPN客户端和局域网之间的接口
Tutorial and discussion=教程和讨论
Tuxera driver=Tuxera驱动
twice=2次
TX=发送
TX/RX Rate=发送/接收速度
Type=类别
UDP Connections=UDP连接
UDP IN/OUT (pkt/s)=UDP 进/出 (pkt/s)
UDP limit=UDP限制
UDP Limit=UDP限制
UDP Timeout=UDP超时
UDPxy integration and GUI=UDPxy集成和GUI
Udpxy port=Udpxy端口
UL Rate=上传速度
ULCeil=上传上限
ULCeil must be greater than ULRate=上传上限必须大于上传速度
ULCeil must between 1 and 99999=上传上限必须在1到99999之间
ULRate=上传速度
ULRate must between 1 and 99999=上传速度必须在1到99999之间
Unable to connect to the interface=不能连接到接口
Unclassified=未分类
Uniform=均匀分布
Unique identifier associated to a network interface on this particular device=在这个特定设备上与网络接口相关的唯一标识符
Unique identifier of a VLAN=VLAN的唯一标识符
United States, Canada=美国，加拿大
Unknown Port Mapping Using Default=未知的端口映射，使用默认
unlimited=无限
Unlisted MAC addresses won't be able to obtain an IP address through DHCP=不在列表里的MAC地址不能从DHCP获得IP地址
Unmount=卸载
Unmount all USB Drives=卸载所有USB设备
Unplugged=已拔出
Unplugged=已拔出
Unreplied=Unreplied
Unsaved changes will be lost. Continue anyway?=未保存的改动将会丢失，继续吗
unset=未设置
Unspecified=未指定
until network is restarted and this page is reloaded=直到网络重启并刷新这个页面
Up=在线
up to 3 extra VIFs can be defined in addition to the primary VIF=除了主VIF可以定义3个额外的VIF
Update Available=可以升级啦
Upgrade=升级
Upgrade Firmware=升级固件
Upgrade forbidden=禁止升级
Upload=上传
Upload (bytes/s)=上传 (bytes/s)
Upload ceil=上传上限
Upload file size limit=上传文件大小限制
Upload limit=上传限速
Upload rate=上传速度
Upload slots per torrent=每种子上传通道
Uploaded=已上传
UPnP / NAT-PMP=UPnP / NAT-PMP
UPnP / NAT-PMP Forwarding=UPnP / NAT-PMP转发
UPnP / NAT-PMP Port Forwarding= UPnP / NAT-PMP端口转发
Upper=较高
UPS Monitor=UPS监控
Uptime=运行时间
Uptime of your router. Ex: 3 days=路由器的运行时间。例如：3天
URL Excluded off Captive Portal=不需被网页认证的URL
URL excluded off the portal=不需要网页认证的URL
URL that will be accessed without Welcome banner screen appearing. When you set allowed url's also leave a blank space between each url. i.e=访问这些URL时候欢迎横幅不会出现，当设置这些URL的时候，每个URL用空格分开，例如
US=美国
USB & NAS=USB & NAS
USB 1.1 Support=USB 1.1
USB 2.0 Support=USB 2.0
USB 3.0 Support=USB 3.0
USB 3G Modem support=USB 3G调制解调器支持
USB and NAS=USB和NAS
USB audio ready fw (GUI)=USB audio ready fw (GUI)
USB Audio Support=USB声卡支持
USB Printer Support=USB打印机支持
USB Storage Support=USB存储支持
USB Support=USB支持
USB support integration and GUI=USB支持集成和GUI
Use=使用
Use '-' to specify a range of ports=使用' - '来指定一个端口范围
Use .incomplete/=使用.incomplete/
Use @IP for the current IP address=用@IP来表示当前IP地址
Use alternate NAS startup=使用备用NAS启动
Use alternate NAS startup sequence=使用备用NAS启动序列
Use as DNS=当作DNS使用
use default=使用默认
Use Default=使用默认
Use DHCP=使用DHCP
Use dnscrypt-proxy=使用dnscrypt-proxy
Use External IP Address Checker (every 10 minutes)=使用外部IP地址检查器（每10分钟）
Use internal DNS=使用内部DNS
Use prefereable one of the two option to avoid conflicts=使用两个选项之一，从而避免冲突
Use received DNS with user-entered DNS=使用接收的DNS和用户指定的DNS
use the=使用
Use the command &quot;nvram show&quot; or &quot;nvram show | grep qos&quot; to cut and paste configuration=使用命令 &quot;nvram show&quot; 或 &quot;nvram show | grep qos&quot;来 剪切和粘贴配置
Use user config file=使用用户配置文件
Use user-entered gateway if WAN is disabled=如果WAN被禁用则使用用户指定的网关
Use WAN IP Address=使用WAN口的IP地址
used=已使用
User Accounts=用户帐户
User config file path=用户配置文件路径
User config file will be used, some of GUI settings will be ignored=用户配置文件将被使用,一些GUI设置将被忽略
User Guide=指南
User ID=用户ID
User Name=用户名
user name cannot contain=用户名不能包含
user name connected to server=连接到服务器的用户名
User names=用户名
Username=用户名
Username / Hostname=用户名 / 主机名
Username and password can not be empty=用户名和密码不能为空
Username Authen. Only=只验证用户名
username is mandatory=用户名是强制性的
Username/Password Authentication=用户名/密码验证
Using QoS=使用Qos
usually=通常
Usually=通常为
Valid range=有效范围
Value=值
Value cannot contain=值不能包含
Value is mandatory=值是强制性的
Various color schemes=各种配色方案
Verify server certificate=验证服务器证书
version=版本
Version=版本
VID Offset=VID偏移
Video only=仅视频
View All=查看所有
View Details=查看详细
View Graphs=查看图表
View IP Traffic History=查看IP流量历史
View Last 100 Lines=查看最后100行
View Last 25 Lines=查看最后25行
View Last 50 Lines=查看最后50行
View Only=仅查看
View Per-Connection Transfer Rates=查看每个连接的传输速度
View QoS Details=查看Qos详情
View real-time IP Traffic for this address=查看该IP实时流量
View Router Logs=查看路由器日志
View transfer rates per connection=按连接查看传输速率
Virtual Interfaces=虚拟接口
Virtual Wireless=虚拟无线
Virtual Wireless Interfaces=无线虚拟接口
VLAN administration GUI=VLAN管理员GUI
VLAN ID assigned to untagged frames received by the router=VLAN ID分配给路由器收到的未标记的帧
VLAN Settings=VLAN设置
VPN Client=VPN客户端
VPN Clients to LAN=VPN客户端到LAN
VPN IP Address=VPN IP地址
VPN Netmask=VPN掩码
VPN Server=VPN服务器
VPN subnet/netmask=VPN子网/掩码
VPN Tunneling=VPN
Wake On LAN=局域网唤醒
Wake on Lan=局域网唤醒
Wake On Lan=局域网唤醒
Wake Up=唤醒
WAN Bandwidth - Daily=WAN流量 - 每日
WAN Bandwidth - Monthly=WAN流量 - 每月
WAN Bandwidth - Weekly=WAN流量 - 每周
WAN Port Speed=WAN端口速度
WAN Up=WAN联机
Warning=警告
WARNING=警告
Warning: 10 second session timeout, restarting=警告：10秒超时，重新启动
Warning: 10 second timeout, restarting=警告：10秒超时，重新启动
Warning: Cannot bridge distinct subnets. Defaulting to routed mode=警告：无法桥接独特的子网。正在设置成默认的路由模式
Warning: Changing the MAC address may require that you reboot all devices, computers or modem connected to this router. Continue anyway?=警告：改动MAC地址可能需要重启所有设备，计算机或者连接到这个路由器的调制解调器，继续吗
WARNING: Erasing the NVRAM on a=警告：擦除NVRAM
Warning: Must define Certificate Authority=警告:必须定义证书颁发机构
Warning: Web Admin is about to be disabled. If you decide to re-enable Web Admin at a later time, it must be done manually via Telnet, SSH or by performing a hardware reset. Are you sure you want to do this?=警告：Web管理员账号将被禁用，如果你之后要重新启用Web管理员账号，你必须手动通过Telnet，SSH，或者硬件复位来完成。你确认要禁用吗？
Warning: Wireless connections to this router may be disrupted while using this tool=警告：使用此工具的时候，到该路由器的无线连接到可能中断
warning: WL driver reports BSSID=警告:WL驱动报告BSSID
WDS MAC address required=需要WDS MAC地址
We want to express our gratitude to all people not mentioned here but contributed with patches, new models additions, bug solving and updates to Tomato firmware=我们想表达我们的感激之情对所有人而不仅仅是这里提到的,那些为开发补丁，添加新的型号支持,解决错误和固件更新作出努力的人
Web Admin=Web管理
Web GUI directory=Web GUI目录
Web Monitor=网络监控
Web Monitor Configuration=网络监控配置
Web Monitoring disabled=网络监控已禁用
Web Server=Web服务器
Web Server Menu=Web服务器菜单
Web Server Name=Web服务器名称
Web Server Port=Web服务器端口
Web Services=Web 服务
Web Usage=网络使用
Webmon Backup Script=Webmon备份脚本
Wed=周三
Wednesday=周三
Week Start=一周开始
Weekly=每周
Weekly Bandwidth=每周带宽
Welcome html Path=欢迎页面目录
Western Europe=西欧
wfilter=无线过滤
When active, the 'Home Page' (read next line) will appear after you Agree in Welcome Banner=启用后，同意欢迎横幅中内容后会显示主页
When ARP binding is enabled for a particular MAC/IP address pair, that device will always be shown as 'active' in the=当特定的MAC/IP地址对启用ARP绑时，设备会显示为“活跃”在
When creating/defining a new wireless VIF, it's MAC address will be shown (incorrectly) as '00:00:00:00:00:00', as it's unknown at that moment=当创建/定义一个新的无线VIF，它的MAC地址将显示(错误地)“00:00:00:00:00:00”,因为那一刻它是未知的
When creating/defining a new wireless VIF, it's MAC address will be shown (incorrectly) as '00:00:00:00:00:00', as it's unknown at that moment (until network is restarted and this page is reloaded)=当创建/定义一个新的无线VIF，它的MAC地址将显示(错误地)“00:00:00:00:00:00”,因为那一刻它是未知的(除非网络重新启动并且本页重新加载)
when enabled, UPnP clients are allowed to add mappings only to their IP=启用时，UPnP的客户端可以只添加映射到其IP
When new tomato version will be available, you will be notified about this on=当Tomato有新的可用版本时，你会收到通知在
When no directory is specified=当没有指定目录
When no directory is specified, /mnt is used as a root directory=当没有指定目录时，/mnt将作为根目录
When no Root Directory is specified for the user, the default=当用户没有指定根目录时,默认
When no Root Directory is specified for the user, the default 'Public Root Directory' is used=当用户没有指定根目录时,默认使用“公共根目录”
When no shares are specified and auto-sharing is disabled=当没有指定共享或自动共享被禁用
When Pushed For=当按住
When saving changes, the MAC addresses of all defined non-primary wireless VIFs could sometimes be (already)=保存更改时,所有定义的非主无线vif的MAC地址有时候(已经)
When saving changes, the MAC addresses of all defined non-primary wireless VIFs could sometimes be (already) <i>set</i> but might be <i>recreated</i> by the WL driver (so that previously defined/saved settings might need to be updated/changed accordingly on=当保存更改时，所有定义的非主无线的VIF的MAC地址有时可能（已经）<i>设置</i>，但也可能是被WL驱动 <i>重建</i>（因此之前定义/保存的设置可能需要更新/改变根据
When setting any port (included or excluded) leave a blank space between each port number, i.e=当设置任何端口重定向（需要或者不需要的）时候，每个端口之间用空格分开，例如
when the network conditions poor, try use long detection period=如果网络条件较差，请使用较大的时间间隔
When you tick and save the router will show a Welcome Banner when a computer access the Internet=通过此设置，当连接到因特网的用户的计算机将显示横幅
Which ethernet ports on the router should be members of this VLAN=路由器上的那些以太网端口应是这个VLAN的成员
Which LAN bridge this VIF should be assigned=这个VIF分配的LAN网桥
White=白色
White SES=白色SES
Wildcard=通配符
will be treated as a file. If this is a directory, please use a trailing /. Continue anyway?=将被当作一个文件，如果这是一个目录，请附加“/”符号，继续吗
WINS Server=WINS服务器
WINS Servers=WINS服务器
Wireless=无线网络
Wireless access has been temporarily disabled for=无线接入已暂时停用：
Wireless Client=无线客户端
Wireless Client Filter=无线客户端过滤器
Wireless Client Mode=无线客户端模式
Wireless Client mode can be set only to one WAN port=无线客户端模式仅可设置到1个WAN口
Wireless Client mode requires a valid WAN setting (usually DHCP)=无线客户端模式，需要一个有效的WAN设置（通常为DHCP）
Wireless Client must be setup in WAN section=无线客户端模式在WAN设置里配置
Wireless connections to this router may be disrupted while using this tool=使用此工具的时候，到该路由器的无线连接到可能中断
Wireless Ethernet Bridge=无线桥接
Wireless Filter=无线过滤
Wireless Interface=无线接口
Wireless Interfaces Details=无线接口详情
Wireless Mode=无线模式
Wireless Multicast Forwarding=无线多播转发
Wireless Network Mode=无线网络模式
Wireless Service Set Identifier=无线服务集标识符
Wireless Settings=无线设置
Wireless Site Survey=无线站点检测
Wireless Survey=无线检测
Wireless Temperature=无线温度
Wireless VIF name=无线VIF名称
With AdvancedTomato you get very few built in skins, others are available on AdvancedTomato Themes Directory. This way we can save space on router for more important functions.=AdvancedTomato内建了少量皮肤，其它的在AdvancedTomato主题目录里。这样我们可以为更多重要功能节约路由器空间。
with the name matching the name of the user=和用户名一样的名字
with this id in your page=在这个页面中包含ID
WLAN Auto with Noise Reduction=WLAN自动降噪
WOL=网络唤醒
Word Wrap=自动换行
Workgroup Name=工作组名称
Working, please wait=工作中，请稍等
works only with non-Hilink modems=不适用于Hilink调制解调器
Write Only=只写
written by=作者
Wrong filename, the correct extension is=文件名错误，正确的扩展名是
Wrong nbw_cap=错误的nbw_cap
XMLHTTPRequest objects. This page requires=XMLHTTPRequest objects。这个页面需要
Yes=是
Yes, Authentication required=是的，需要验证
Yes, i do and want to make a choice=是的，我知道并且我会作出选择
Yes, i`m sure i do=是的，我肯定会启用
Yes, LAN only=是的，仅LAN
Yes, no Authentication=是的，无身份验证
Yes, WAN and LAN=是的，WAN和LAN
You can add other values to nginx.conf in declaration of http {} to suit your needs=你可以添加其他值到http {}声明的nginx.conf来满足你的需求
You can add other values to nginx.conf in declaration of server {} to suit your needs=你可以添加其他值到server {}声明的nginx.conf来满足你的需求
You can add other values to nginx.conf to suit your needs=你可以在nginx.conf添加其他的值来满足你的需求
You can add other values to php.ini to suit your needs=你可以添加其他值到php.ini来满足你的需求
You can always re-enable it at any time=你可以在任何时候重新启用它
You can always toggle navigation style by clicking an icon right to logo, but doing so won`t change default state=您可以随时通过点击旁边的标志图标更改菜单的外观，但此操作不会更改默认位置
You can check which version of Tomato is most commonly used and which one is the most stable=您可以检查哪些Tomato的版本是最常用的，稳定的
You can find more information on proper NFS configuration at the following website=你可以在以下网站找到更多关于NFS配置的信息
You can now unplug the router=您现在可以拔掉路由器电源
You did not configure=你没有配置
You did not configure <b>TomatoAnon project</b> setting=你没有配置 <b>TomatoAnon 项目</b> 设置
You may continue anyway but remember=你可以继续但是必须要记住
You may need to release then renew your computer's DHCP lease before continuing= 您可能需要释放并更新您的计算机DHCP的租约，然后再继续操作
You may need to renew your computer's DHCP or reboot your computer before continuing=您可能需要更新您的计算机的DHCP或重新启动计算机，然后再继续操作
You need a div or span element=你需要一个div和span元素
you was warned=警告
Zoom Graphs=缩放图表
